ed_map_for_viz,Trump,Clinton,vote_differences,total_value,trump_pct,clinton_pct,vote_counts_pct
77001,10,200,-190,430,2.3255813953488373,46.51162790697674,-44.18604651162791
77002,11,219,-208,467,2.355460385438972,46.895074946466806,-44.53961456102783
77003,10,378,-368,781,1.2804097311139564,48.399487836107554,-47.1190781049936
77004,19,464,-445,979,1.940755873340143,47.3953013278856,-45.45454545454545
77005,20,702,-682,1473,1.3577732518669383,47.657841140529534,-46.300067888662596
77006,28,617,-589,1310,2.1374045801526718,47.099236641221374,-44.961832061068705
77007,29,672,-643,1425,2.0350877192982457,47.1578947368421,-45.122807017543856
77008,22,700,-678,1454,1.5130674002751032,48.143053645116915,-46.62998624484181
77009,36,720,-684,1537,2.342225113858165,46.8445022771633,-44.50227716330514
77010,32,522,-490,1119,2.8596961572832886,46.64879356568365,-43.78909740840036
77011,32,676,-644,1429,2.239328201539538,47.30580825752274,-45.066480055983206
77012,26,590,-564,1254,2.073365231259968,47.04944178628389,-44.97607655502392
77013,28,660,-632,1397,2.0042949176807445,47.24409448818898,-45.23979957050823
77014,36,424,-388,934,3.854389721627409,45.396145610278374,-41.54175588865097
77015,32,572,-540,1232,2.5974025974025974,46.42857142857143,-43.83116883116883
77016,21,404,-383,854,2.459016393442623,47.306791569086656,-44.84777517564403
77017,7,195,-188,410,1.707317073170732,47.5609756097561,-45.853658536585364
77018,20,493,-473,1041,1.921229586935639,47.358309317963496,-45.43707973102786
77019,23,498,-475,1068,2.153558052434457,46.62921348314607,-44.47565543071161
77020,28,447,-419,971,2.883625128733265,46.03501544799176,-43.151390319258496
77021,26,478,-452,1025,2.5365853658536586,46.63414634146342,-44.09756097560976
77022,29,520,-491,1108,2.6173285198555956,46.931407942238266,-44.31407942238267
77023,29,713,-684,1495,1.939799331103679,47.69230769230769,-45.752508361204015
77024,23,550,-527,1164,1.9759450171821304,47.250859106529205,-45.27491408934708
77025,22,628,-606,1318,1.669195751138088,47.64795144157815,-45.97875569044006
77026,12,207,-195,442,2.7149321266968327,46.83257918552036,-44.11764705882353
77027,20,608,-588,1278,1.5649452269170578,47.57433489827856,-46.0093896713615
77028,22,594,-572,1260,1.746031746031746,47.14285714285714,-45.39682539682539
77029,14,164,-150,360,3.888888888888889,45.55555555555556,-41.66666666666667
77030,11,290,-279,624,1.7628205128205128,46.47435897435898,-44.71153846153847
77031,3,72,-69,150,2.0,48.0,-46.0
77032,1,73,-72,152,0.6578947368421052,48.026315789473685,-47.36842105263158
77033,17,356,-339,761,2.2339027595269383,46.78055190538765,-44.546649145860705
77034,35,604,-569,1298,2.6964560862865947,46.5331278890601,-43.8366718027735
77035,19,584,-565,1221,1.556101556101556,47.82964782964783,-46.27354627354627
77036,17,301,-284,651,2.61136712749616,46.236559139784944,-43.625192012288785
77037,11,414,-403,865,1.2716763005780347,47.861271676300575,-46.58959537572254
77038,15,295,-280,636,2.358490566037736,46.38364779874214,-44.0251572327044
77039,23,526,-503,1120,2.0535714285714284,46.964285714285715,-44.910714285714285
77040,17,362,-345,772,2.2020725388601035,46.89119170984456,-44.68911917098446
77041,23,419,-396,893,2.57558790593505,46.920492721164614,-44.34490481522956
77042,32,588,-556,1252,2.5559105431309903,46.96485623003195,-44.40894568690096
77043,21,516,-495,1095,1.9178082191780823,47.12328767123288,-45.205479452054796
77044,33,575,-542,1228,2.687296416938111,46.82410423452769,-44.13680781758958
77045,11,338,-327,717,1.5341701534170153,47.140864714086476,-45.60669456066946
77046,50,529,-479,1182,4.230118443316413,44.75465313028765,-40.524534686971236
77047,15,469,-454,983,1.5259409969481181,47.71108850457782,-46.18514750762971
77048,33,599,-566,1279,2.580140734949179,46.83346364347146,-44.25332290852228
77049,8,195,-187,415,1.9277108433734942,46.98795180722892,-45.06024096385542
77050,21,550,-529,1165,1.8025751072961373,47.21030042918455,-45.407725321888414
77051,18,528,-510,1103,1.6319129646418857,47.86944696282865,-46.23753399818676
77052,5,95,-90,203,2.4630541871921183,46.79802955665024,-44.33497536945812
77053,10,453,-443,940,1.0638297872340425,48.191489361702125,-47.12765957446808
77054,12,490,-478,1021,1.1753183153770812,47.992164544564154,-46.81684622918707
77055,15,520,-505,1081,1.3876040703052728,48.1036077705828,-46.716003700277525
77056,18,469,-451,991,1.8163471241170535,47.32593340060545,-45.5095862764884
77057,22,447,-425,988,2.2267206477732793,45.24291497975709,-43.01619433198381
77058,11,621,-610,1293,0.8507347254447023,48.027842227378194,-47.17710750193349
77059,17,317,-300,687,2.4745269286754,46.142649199417754,-43.66812227074235
77060,23,364,-341,791,2.9077117572692797,46.017699115044245,-43.10998735777496
77061,10,168,-158,368,2.717391304347826,45.65217391304348,-42.93478260869565
77062,7,445,-438,921,0.760043431053203,48.31704668838219,-47.55700325732899
77063,18,543,-525,1131,1.5915119363395225,48.01061007957559,-46.41909814323607
77064,14,148,-134,330,4.242424242424243,44.84848484848485,-40.60606060606061
77065,23,627,-604,1334,1.7241379310344827,47.00149925037481,-45.27736131934033
77066,3,56,-53,120,2.5,46.666666666666664,-44.166666666666664
77067,15,343,-328,722,2.0775623268698062,47.50692520775623,-45.42936288088643
77068,9,371,-362,782,1.1508951406649617,47.44245524296675,-46.29156010230179
77070,0,0,0,0,0.0,0.0,0.0
77071,17,400,-383,842,2.019002375296912,47.50593824228028,-45.486935866983366
77072,22,388,-366,842,2.6128266033254155,46.080760095011875,-43.46793349168646
77073,0,0,0,0,0.0,0.0,0.0
77074,19,379,-360,809,2.3485784919653896,46.84796044499382,-44.499381953028426
77075,16,228,-212,502,3.187250996015936,45.41832669322709,-42.23107569721115
77076,13,265,-252,572,2.272727272727273,46.32867132867133,-44.05594405594405
77077,5,259,-254,531,0.9416195856873822,48.7758945386064,-47.83427495291902
78001,16,604,-588,1256,1.2738853503184715,48.089171974522294,-46.81528662420382
78002,20,617,-597,1291,1.549186676994578,47.79240898528273,-46.243222308288146
78003,33,257,-224,598,5.518394648829431,42.97658862876254,-37.458193979933114
78004,42,568,-526,1249,3.362690152121697,45.476381104883906,-42.11369095276221
78005,51,549,-498,1230,4.146341463414634,44.63414634146341,-40.48780487804878
78006,58,617,-559,1384,4.190751445086705,44.580924855491325,-40.39017341040462
78007,27,134,-107,342,7.894736842105263,39.1812865497076,-31.286549707602337
78008,56,427,-371,1013,5.528134254689043,42.15202369200395,-36.62388943731491
78009,17,360,-343,789,2.1546261089987326,45.627376425855516,-43.47275031685678
78010,20,428,-408,910,2.197802197802198,47.03296703296703,-44.83516483516483
78011,27,429,-402,927,2.912621359223301,46.27831715210356,-43.36569579288026
78012,22,408,-386,866,2.5404157043879905,47.11316397228637,-44.57274826789838
78013,27,486,-459,1048,2.5763358778625953,46.37404580152672,-43.79770992366412
78014,18,427,-409,903,1.9933554817275747,47.286821705426355,-45.29346622369878
78015,22,257,-235,567,3.880070546737213,45.326278659611994,-41.44620811287478
78016,18,297,-279,642,2.803738317757009,46.26168224299065,-43.45794392523364
78017,8,252,-244,522,1.532567049808429,48.275862068965516,-46.74329501915709
78018,17,450,-433,943,1.8027571580063628,47.720042417815485,-45.91728525980912
78019,33,442,-409,958,3.4446764091858038,46.13778705636743,-42.693110647181626
78020,30,433,-403,958,3.1315240083507305,45.19832985386221,-42.06680584551148
78021,21,320,-299,701,2.9957203994293864,45.6490727532097,-42.65335235378031
78022,14,333,-319,710,1.971830985915493,46.901408450704224,-44.92957746478873
78023,32,604,-572,1297,2.467232074016962,46.569005397070164,-44.1017733230532
78024,46,631,-585,1374,3.3478893740902476,45.924308588064044,-42.57641921397379
78025,36,441,-405,966,3.7267080745341614,45.65217391304348,-41.92546583850932
78026,18,534,-516,1130,1.592920353982301,47.256637168141594,-45.663716814159294
78027,24,500,-476,1058,2.2684310018903595,47.25897920604915,-44.990548204158785
78028,31,360,-329,802,3.865336658354115,44.88778054862843,-41.02244389027431
78029,24,509,-485,1079,2.2242817423540315,47.173308619091756,-44.949026876737726
78030,70,569,-499,1316,5.319148936170213,43.237082066869306,-37.91793313069909
78031,45,484,-439,1087,4.139834406623735,44.52621895124195,-40.38638454461822
78032,55,395,-340,931,5.907626208378089,42.42749731471536,-36.51987110633727
78033,77,658,-581,1548,4.974160206718346,42.50645994832041,-37.53229974160207
78034,30,393,-363,883,3.397508493771234,44.50736126840317,-41.10985277463194
78035,26,139,-113,343,7.580174927113703,40.524781341107875,-32.94460641399417
78036,37,479,-442,1055,3.5071090047393367,45.40284360189574,-41.895734597156405
78037,4,57,-53,126,3.1746031746031744,45.23809523809524,-42.06349206349206
78038,51,542,-491,1215,4.197530864197531,44.609053497942384,-40.41152263374485
78039,36,180,-144,464,7.758620689655173,38.793103448275865,-31.03448275862069
78040,90,615,-525,1457,6.177076183939602,42.21002059025395,-36.03294440631434
78041,110,448,-338,1155,9.523809523809524,38.78787878787879,-29.264069264069263
78042,0,3,-3,6,0.0,50.0,-50.0
78043,8,183,-175,384,2.083333333333333,47.65625,-45.572916666666664
78044,25,264,-239,590,4.23728813559322,44.74576271186441,-40.50847457627119
78045,35,512,-477,1135,3.0837004405286343,45.11013215859031,-42.02643171806167
78046,32,576,-544,1236,2.5889967637540456,46.601941747572816,-44.01294498381877
78047,25,519,-494,1124,2.224199288256228,46.17437722419929,-43.95017793594306
78048,49,639,-590,1428,3.431372549019608,44.747899159663866,-41.31652661064426
78049,30,526,-496,1150,2.608695652173913,45.73913043478261,-43.130434782608695
78050,31,506,-475,1115,2.780269058295964,45.38116591928251,-42.600896860986545
78051,23,421,-398,912,2.5219298245614032,46.16228070175439,-43.640350877192986
78052,29,565,-536,1212,2.392739273927393,46.617161716171616,-44.224422442244226
78053,16,500,-484,1059,1.5108593012275733,47.21435316336166,-45.70349386213408
78054,16,305,-289,659,2.4279210925644916,46.28224582701062,-43.85432473444613
78055,0,0,0,0,0.0,0.0,0.0
78056,0,0,0,0,0.0,0.0,0.0
78057,0,0,0,0,0.0,0.0,0.0
78059,13,185,-172,403,3.225806451612903,45.90570719602978,-42.67990074441688
78060,26,451,-425,982,2.6476578411405294,45.926680244399186,-43.27902240325866
78061,24,291,-267,645,3.7209302325581395,45.11627906976744,-41.3953488372093
78062,25,288,-263,650,3.8461538461538463,44.30769230769231,-40.46153846153846
78063,9,241,-232,509,1.768172888015717,47.347740667976424,-45.579567779960705
78064,14,341,-327,726,1.9283746556473829,46.96969696969697,-45.04132231404959
78065,20,270,-250,596,3.3557046979865772,45.302013422818796,-41.94630872483222
78066,20,285,-265,621,3.22061191626409,45.893719806763286,-42.673107890499196
78067,44,322,-278,758,5.804749340369393,42.480211081794195,-36.675461741424805
79001,20,599,-579,1258,1.5898251192368837,47.61526232114468,-46.02543720190779
79002,18,426,-408,902,1.9955654101995564,47.22838137472284,-45.23281596452328
79003,15,464,-449,979,1.5321756894790604,47.3953013278856,-45.86312563840654
79004,15,336,-321,706,2.1246458923512748,47.59206798866856,-45.467422096317286
79005,9,534,-525,1098,0.819672131147541,48.63387978142077,-47.814207650273225
79006,28,356,-328,784,3.571428571428571,45.40816326530612,-41.83673469387755
79007,16,469,-453,989,1.6177957532861478,47.4216380182002,-45.80384226491405
79008,10,296,-286,624,1.6025641025641024,47.43589743589743,-45.83333333333333
79009,6,221,-215,470,1.276595744680851,47.02127659574468,-45.744680851063826
79010,17,581,-564,1227,1.3854930725346373,47.35126324368378,-45.965770171149146
79011,18,185,-167,420,4.285714285714286,44.047619047619044,-39.76190476190476
79012,7,117,-110,254,2.7559055118110236,46.06299212598425,-43.30708661417323
79013,34,581,-547,1252,2.7156549520766773,46.405750798722046,-43.69009584664537
79014,8,144,-136,311,2.572347266881029,46.30225080385852,-43.72990353697749
79015,18,428,-410,899,2.0022246941045605,47.60845383759733,-45.60622914349277
79016,16,425,-409,900,1.7777777777777777,47.22222222222222,-45.44444444444444
79017,27,476,-449,1019,2.649656526005888,46.712463199214916,-44.062806673209025
79018,13,399,-386,845,1.5384615384615385,47.218934911242606,-45.680473372781066
79019,18,302,-284,646,2.786377708978328,46.749226006191954,-43.962848297213625
79020,15,351,-336,745,2.013422818791946,47.11409395973155,-45.1006711409396
79021,19,294,-275,639,2.97339593114241,46.009389671361504,-43.03599374021909
79022,10,268,-258,561,1.7825311942959003,47.771836007130126,-45.98930481283423
79023,18,373,-355,797,2.258469259723965,46.800501882057716,-44.54203262233375
79024,24,441,-417,948,2.5316455696202533,46.51898734177215,-43.9873417721519
79025,19,455,-436,967,1.9648397104446742,47.05274043433299,-45.08790072388832
79026,18,391,-373,829,2.1712907117008444,47.165259348612786,-44.993968636911944
79027,24,548,-524,1160,2.0689655172413794,47.241379310344826,-45.172413793103445
79028,39,696,-657,1497,2.6052104208416833,46.49298597194389,-43.8877755511022
79030,23,370,-347,803,2.86425902864259,46.07721046077211,-43.212951432129515
79031,7,445,-438,919,0.7616974972796519,48.42219804134929,-47.66050054406964
79032,17,370,-353,790,2.151898734177215,46.835443037974684,-44.68354430379747
79033,12,355,-343,745,1.6107382550335572,47.651006711409394,-46.040268456375834
79034,21,404,-383,868,2.4193548387096775,46.54377880184332,-44.12442396313364
79035,17,493,-476,1033,1.6456921587608906,47.72507260406583,-46.07938044530494
79036,6,177,-171,372,1.6129032258064515,47.58064516129033,-45.96774193548388
79037,4,249,-245,512,0.78125,48.6328125,-47.8515625
79038,7,531,-524,1098,0.6375227686703097,48.36065573770492,-47.72313296903461
79039,17,571,-554,1180,1.4406779661016949,48.389830508474574,-46.94915254237288
79040,24,650,-626,1371,1.75054704595186,47.410649161196204,-45.66010211524434
79041,11,519,-508,1078,1.0204081632653061,48.144712430426715,-47.124304267161406
79042,25,513,-488,1095,2.28310502283105,46.849315068493155,-44.5662100456621
79043,18,345,-327,739,2.435723951285521,46.68470906630582,-44.248985115020304
79044,32,545,-513,1170,2.735042735042735,46.58119658119658,-43.84615384615385
79045,31,683,-652,1454,2.1320495185694637,46.97386519944979,-44.84181568088032
79046,14,587,-573,1223,1.1447260834014716,47.996729354047424,-46.85200327064595
79047,26,609,-583,1281,2.029664324746292,47.540983606557376,-45.51131928181108
79048,13,349,-336,736,1.766304347826087,47.41847826086957,-45.652173913043484
79049,13,382,-369,813,1.5990159901599015,46.98646986469865,-45.38745387453875
79050,22,468,-446,993,2.2155085599194364,47.129909365558916,-44.91440080563948
79051,14,429,-415,906,1.545253863134658,47.35099337748344,-45.80573951434878
79052,25,575,-550,1232,2.029220779220779,46.67207792207792,-44.64285714285714
79053,20,462,-442,985,2.030456852791878,46.90355329949239,-44.87309644670051
79054,12,304,-292,648,1.8518518518518516,46.913580246913575,-45.06172839506172
79055,7,101,-94,224,3.125,45.089285714285715,-41.964285714285715
79056,29,472,-443,1022,2.8375733855185907,46.1839530332681,-43.34637964774951
79057,22,587,-565,1245,1.7670682730923692,47.14859437751004,-45.38152610441767
79058,23,474,-451,1009,2.2794846382556986,46.97720515361744,-44.697720515361745
79059,31,462,-431,998,3.106212424849699,46.292585170340686,-43.186372745490985
79060,14,244,-230,527,2.6565464895635675,46.29981024667932,-43.643263757115754
79061,22,500,-478,1076,2.0446096654275094,46.468401486988846,-44.42379182156134
79062,28,524,-496,1120,2.5,46.785714285714285,-44.285714285714285
79063,20,540,-520,1134,1.763668430335097,47.61904761904761,-45.85537918871252
79064,3,240,-237,486,0.6172839506172839,49.382716049382715,-48.76543209876543
79065,18,463,-445,979,1.8386108273748722,47.29315628192033,-45.45454545454546
79066,12,402,-390,840,1.4285714285714286,47.85714285714286,-46.42857142857143
79067,10,246,-236,516,1.937984496124031,47.674418604651166,-45.736434108527135
79068,21,604,-583,1268,1.6561514195583598,47.63406940063091,-45.97791798107255
79069,52,912,-860,1969,2.6409344845099034,46.31792788217369,-43.676993397663786
79070,8,309,-301,643,1.244167962674961,48.055987558320375,-46.81181959564542
79071,20,577,-557,1202,1.6638935108153077,48.00332778702163,-46.339434276206326
79072,22,544,-522,1152,1.9097222222222223,47.22222222222222,-45.3125
79073,30,350,-320,777,3.861003861003861,45.04504504504504,-41.184041184041185
79074,2,90,-88,186,1.0752688172043012,48.38709677419355,-47.31182795698925
79075,33,525,-492,1131,2.9177718832891246,46.41909814323608,-43.50132625994695
79076,34,405,-371,901,3.7735849056603774,44.950055493895675,-41.1764705882353
79077,3,142,-139,303,0.9900990099009901,46.864686468646866,-45.87458745874588
79078,5,199,-194,418,1.1961722488038278,47.60765550239234,-46.411483253588514
79079,3,223,-220,455,0.6593406593406593,49.01098901098901,-48.35164835164835
79080,0,0,0,0,0.0,0.0,0.0
79081,0,0,0,0,0.0,0.0,0.0
79082,18,846,-828,1743,1.0327022375215147,48.53700516351119,-47.50430292598968
79083,14,489,-475,1026,1.364522417153996,47.66081871345029,-46.29629629629629
79084,33,519,-486,1118,2.9516994633273703,46.422182468694096,-43.470483005366724
79085,11,316,-305,660,1.6666666666666667,47.878787878787875,-46.21212121212121
79086,20,488,-468,1022,1.9569471624266144,47.74951076320939,-45.79256360078278
80001,60,226,-166,595,10.084033613445378,37.983193277310924,-27.899159663865547
80002,18,253,-235,574,3.1358885017421603,44.076655052264805,-40.940766550522646
80003,276,124,152,825,33.45454545454545,15.03030303030303,18.424242424242422
80004,143,174,-31,663,21.568627450980394,26.244343891402718,-4.675716440422324
80005,92,105,-13,408,22.54901960784314,25.735294117647058,-3.186274509803919
80006,125,183,-58,638,19.59247648902821,28.683385579937305,-9.090909090909093
80007,108,206,-98,643,16.796267496111973,32.03732503888025,-15.241057542768274
80008,80,233,-153,649,12.326656394453005,35.901386748844374,-23.57473035439137
80009,44,226,-182,549,8.014571948998178,41.16575591985428,-33.151183970856096
80010,97,324,-227,865,11.213872832369942,37.45664739884393,-26.242774566473983
80011,16,112,-96,263,6.083650190114068,42.585551330798474,-36.5019011406844
80012,32,211,-179,494,6.477732793522267,42.71255060728745,-36.23481781376518
80013,57,358,-301,847,6.729634002361275,42.26682408500591,-35.537190082644635
80014,15,321,-306,695,2.158273381294964,46.18705035971223,-44.02877697841727
80015,30,230,-200,535,5.607476635514018,42.99065420560748,-37.38317757009346
80016,96,568,-472,1372,6.997084548104956,41.39941690962099,-34.40233236151603
80017,32,482,-450,1059,3.0217186024551466,45.51463644948065,-42.4929178470255
80018,135,222,-87,732,18.442622950819672,30.327868852459016,-11.885245901639344
80019,114,129,-15,506,22.529644268774703,25.494071146245062,-2.964426877470359
80020,99,332,-233,903,10.96345514950166,36.76633444075305,-25.802879291251386
80021,64,538,-474,1261,5.07533703409992,42.664551942902456,-37.58921490880253
80022,33,341,-308,779,4.2362002567394095,43.77406931964056,-39.53786906290115
80023,115,490,-375,1253,9.177972865123703,39.10614525139665,-29.928172386272944
80024,64,680,-616,1539,4.158544509421702,44.184535412605584,-40.02599090318388
80025,60,465,-405,1084,5.535055350553505,42.89667896678967,-37.361623616236166
80026,52,337,-285,810,6.419753086419753,41.604938271604944,-35.18518518518519
80027,89,200,-111,600,14.833333333333334,33.33333333333333,-18.499999999999993
80028,119,284,-165,848,14.033018867924529,33.490566037735846,-19.457547169811317
80029,54,102,-48,326,16.56441717791411,31.28834355828221,-14.723926380368102
80030,220,262,-42,1006,21.868787276341948,26.043737574552683,-4.174950298210735
80031,239,401,-162,1319,18.11978771796816,30.401819560272937,-12.282031842304779
80032,143,174,-31,654,21.865443425076453,26.605504587155966,-4.740061162079513
80033,124,148,-24,572,21.678321678321677,25.874125874125873,-4.195804195804197
80034,119,275,-156,813,14.637146371463713,33.82533825338253,-19.18819188191882
80035,110,205,-95,644,17.080745341614907,31.832298136645964,-14.751552795031056
80036,111,383,-272,1021,10.871694417238002,37.51224289911851,-26.640548481880508
80037,105,167,-62,552,19.021739130434785,30.253623188405797,-11.231884057971012
80038,64,290,-226,737,8.683853459972863,39.348710990502035,-30.664857530529172
80039,92,283,-191,767,11.994784876140809,36.89700130378096,-24.902216427640152
80040,25,248,-223,560,4.464285714285714,44.285714285714285,-39.82142857142857
80041,75,638,-563,1468,5.108991825613079,43.46049046321526,-38.35149863760218
80042,31,335,-304,737,4.2062415196743554,45.45454545454545,-41.248303934871096
80043,59,326,-267,791,7.458912768647282,41.21365360303413,-33.75474083438685
80044,60,283,-223,701,8.559201141226819,40.37089871611983,-31.811697574893014
80045,96,521,-425,1260,7.6190476190476195,41.34920634920635,-33.73015873015873
80046,24,194,-170,445,5.393258426966292,43.59550561797752,-38.20224719101123
80047,54,311,-257,753,7.171314741035857,41.301460823373176,-34.13014608233732
80048,30,280,-250,633,4.739336492890995,44.23380726698262,-39.494470774091624
80049,4,82,-78,176,2.272727272727273,46.590909090909086,-44.31818181818181
80050,44,565,-521,1251,3.5171862509992007,45.1638689048761,-41.646682653876894
80051,49,159,-110,423,11.583924349881796,37.5886524822695,-26.004728132387704
80052,35,476,-441,1056,3.3143939393939394,45.07575757575758,-41.76136363636364
80053,21,302,-281,659,3.1866464339908953,45.82701062215478,-42.640364188163886
80054,19,133,-114,319,5.956112852664576,41.692789968652036,-35.73667711598746
80055,62,632,-570,1407,4.4065387348969445,44.9182658137882,-40.511727078891255
80056,19,506,-487,1063,1.7873941674506115,47.60112888052681,-45.813734713076194
80057,26,241,-215,552,4.710144927536232,43.65942028985507,-38.949275362318836
80058,58,360,-302,858,6.75990675990676,41.95804195804196,-35.1981351981352
80059,11,90,-79,208,5.288461538461538,43.269230769230774,-37.98076923076923
80060,27,625,-598,1339,2.0164301717699775,46.676624346527255,-44.66019417475728
80061,4,89,-85,191,2.094240837696335,46.596858638743456,-44.50261780104712
80062,33,373,-340,843,3.9145907473309607,44.246737841043895,-40.33214709371293
80063,23,473,-450,1012,2.272727272727273,46.73913043478261,-44.466403162055336
80064,25,382,-357,829,3.0156815440289506,46.07961399276236,-43.06393244873341
80065,13,559,-546,1163,1.117798796216681,48.06534823731729,-46.947549441100605
80066,98,272,-174,756,12.962962962962962,35.978835978835974,-23.015873015873012
80067,87,351,-264,896,9.709821428571429,39.174107142857146,-29.464285714285715
80068,96,319,-223,855,11.228070175438596,37.30994152046784,-26.081871345029242
80069,18,143,-125,331,5.438066465256798,43.202416918429,-37.764350453172206
80070,50,403,-353,927,5.393743257820928,43.47357065803668,-38.07982740021575
80071,42,330,-288,775,5.419354838709677,42.58064516129032,-37.16129032258064
80073,29,277,-248,618,4.692556634304207,44.82200647249191,-40.129449838187696
80074,18,606,-588,1273,1.4139827179890023,47.604084838963075,-46.190102120974075
80075,0,10,-10,20,0.0,50.0,-50.0
80076,63,275,-212,698,9.025787965616045,39.39828080229226,-30.372492836676216
80077,32,522,-490,1128,2.8368794326241136,46.27659574468085,-43.43971631205673
80078,41,590,-549,1305,3.1417624521072796,45.21072796934866,-42.06896551724138
80079,54,525,-471,1184,4.5608108108108105,44.34121621621622,-39.7804054054054
80080,63,649,-586,1467,4.294478527607362,44.23994546693933,-39.94546693933197
80081,54,637,-583,1409,3.8325053229240598,45.209368346344924,-41.37686302342087
80082,38,232,-194,575,6.608695652173912,40.34782608695652,-33.73913043478261
80083,62,486,-424,1152,5.381944444444445,42.1875,-36.80555555555556
80084,52,543,-491,1227,4.2379788101059495,44.25427872860636,-40.01629991850041
80085,56,581,-525,1305,4.291187739463601,44.52107279693487,-40.229885057471265
80086,44,627,-583,1365,3.223443223443224,45.934065934065934,-42.71062271062271
80087,17,210,-193,471,3.6093418259023355,44.5859872611465,-40.976645435244166
80088,0,0,0,0,0.0,0.0,0.0
80089,0,0,0,0,0.0,0.0,0.0
80092,0,0,0,0,0.0,0.0,0.0
81001,21,404,-383,871,2.4110218140068884,46.38346727898966,-43.972445464982776
81002,57,487,-430,1101,5.177111716621254,44.23251589464123,-39.05540417801998
81003,14,166,-152,363,3.8567493112947657,45.73002754820937,-41.87327823691461
81004,57,615,-558,1375,4.1454545454545455,44.72727272727273,-40.58181818181818
81005,38,538,-500,1186,3.204047217537943,45.362563237774026,-42.158516020236085
81006,53,474,-421,1077,4.921077065923862,44.01114206128134,-39.09006499535748
81007,69,591,-522,1363,5.062362435803375,43.36023477622891,-38.297872340425535
81008,22,264,-242,590,3.728813559322034,44.74576271186441,-41.016949152542374
81009,23,359,-336,783,2.937420178799489,45.84929757343551,-42.911877394636015
81010,13,157,-144,354,3.672316384180791,44.35028248587571,-40.67796610169492
81011,9,104,-95,226,3.982300884955752,46.017699115044245,-42.03539823008849
81012,69,527,-458,1249,5.524419535628502,42.1937550040032,-36.6693354683747
81013,39,258,-219,618,6.310679611650485,41.74757281553398,-35.43689320388349
81014,61,345,-284,853,7.151230949589683,40.44548651817116,-33.29425556858148
81015,77,497,-420,1198,6.42737896494157,41.48580968280468,-35.05843071786311
81016,0,0,0,0,0.0,0.0,0.0
81017,23,582,-559,1228,1.8729641693811077,47.39413680781759,-45.52117263843648
81018,31,561,-530,1205,2.572614107883817,46.55601659751037,-43.983402489626556
81019,18,345,-327,740,2.4324324324324325,46.62162162162162,-44.189189189189186
81020,56,577,-521,1298,4.314329738058552,44.45300462249615,-40.1386748844376
81021,34,491,-457,1056,3.2196969696969697,46.496212121212125,-43.276515151515156
81022,15,431,-416,915,1.639344262295082,47.10382513661202,-45.46448087431694
81023,32,575,-543,1255,2.549800796812749,45.81673306772908,-43.266932270916335
81024,27,369,-342,806,3.3498759305210917,45.78163771712159,-42.4317617866005
81025,134,172,-38,635,21.102362204724407,27.086614173228345,-5.984251968503937
81026,97,182,-85,596,16.2751677852349,30.536912751677853,-14.261744966442954
81027,153,158,-5,649,23.57473035439137,24.345146379044685,-0.7704160246533149
81028,149,199,-50,750,19.866666666666667,26.53333333333333,-6.666666666666664
81029,126,140,-14,555,22.702702702702705,25.225225225225223,-2.522522522522518
81030,181,199,-18,800,22.625,24.875,-2.25
81031,159,167,-8,683,23.2796486090776,24.45095168374817,-1.1713030746705684
81032,149,157,-8,637,23.390894819466247,24.646781789638933,-1.2558869701726856
81033,72,397,-325,995,7.236180904522612,39.89949748743719,-32.663316582914575
81034,66,383,-317,939,7.0287539936102235,40.788072417465386,-33.75931842385516
81035,65,322,-257,821,7.917174177831912,39.2204628501827,-31.30328867235079
81036,119,661,-542,1626,7.318573185731856,40.65190651906519,-33.333333333333336
81037,74,533,-459,1258,5.88235294117647,42.368839427662955,-36.486486486486484
81038,37,621,-584,1334,2.7736131934032984,46.55172413793103,-43.77811094452773
81039,36,299,-263,707,5.091937765205092,42.29137199434229,-37.199434229137196
81040,49,568,-519,1269,3.8613081166272654,44.759653270291565,-40.8983451536643
81041,125,528,-403,1378,9.071117561683598,38.31640058055152,-29.245283018867923
81042,36,148,-112,377,9.549071618037134,39.257294429708224,-29.708222811671092
81043,81,308,-227,813,9.96309963099631,37.88437884378843,-27.921279212792122
81044,81,209,-128,611,13.2569558101473,34.20621931260229,-20.949263502454993
81045,16,113,-97,262,6.106870229007633,43.12977099236641,-37.02290076335878
81046,28,206,-178,705,3.9716312056737593,29.219858156028366,-25.248226950354606
81047,32,113,-81,308,10.38961038961039,36.688311688311686,-26.298701298701296
81048,60,363,-303,884,6.787330316742081,41.06334841628959,-34.276018099547514
81049,81,285,-204,787,10.292249047013977,36.213468869123254,-25.92121982210928
81050,67,389,-322,961,6.971904266389179,40.4786680541103,-33.50676378772112
81051,63,317,-254,808,7.797029702970297,39.23267326732673,-31.435643564356432
81052,44,147,-103,401,10.972568578553615,36.65835411471321,-25.6857855361596
81053,55,135,-80,402,13.681592039800993,33.582089552238806,-19.900497512437813
81054,91,493,-402,1235,7.368421052631578,39.91902834008097,-32.550607287449395
81055,129,442,-313,1183,10.904480135249365,37.362637362637365,-26.458157227388
81056,136,455,-319,1236,11.003236245954692,36.81229773462783,-25.80906148867314
81057,81,257,-176,723,11.20331950207469,35.5463347164592,-24.343015214384508
81058,85,351,-266,904,9.402654867256636,38.82743362831859,-29.42477876106195
81059,118,226,-108,745,15.838926174496645,30.335570469798657,-14.496644295302012
81060,157,308,-151,972,16.152263374485596,31.68724279835391,-15.534979423868315
81061,60,185,-125,516,11.627906976744185,35.85271317829458,-24.224806201550393
81062,66,358,-292,879,7.508532423208192,40.72810011376564,-33.21956769055745
81063,137,334,-197,985,13.908629441624365,33.90862944162436,-20.0
81064,120,685,-565,1651,7.268322228952149,41.490006056935194,-34.22168382798304
81065,144,411,-267,1164,12.371134020618557,35.30927835051546,-22.938144329896907
81066,82,213,-131,616,13.311688311688311,34.57792207792208,-21.26623376623377
81067,67,298,-231,755,8.874172185430464,39.47019867549669,-30.596026490066226
81068,92,432,-340,1100,8.363636363636363,39.27272727272727,-30.90909090909091
81069,138,516,-378,1354,10.19202363367799,38.10930576070901,-27.917282127031022
81070,30,147,-117,366,8.19672131147541,40.16393442622951,-31.967213114754102
81071,159,626,-467,1651,9.6305269533616,37.91641429436705,-28.285887341005452
81072,115,435,-320,1162,9.896729776247849,37.43545611015491,-27.53872633390706
81073,81,349,-268,893,9.070548712206048,39.08174692049272,-30.01119820828667
81074,87,407,-320,1023,8.504398826979472,39.784946236559136,-31.280547409579665
81075,82,445,-363,1111,7.380738073807381,40.054005400540056,-32.67326732673268
81076,85,390,-305,997,8.525576730190572,39.1173520561685,-30.591775325977927
81077,79,386,-307,970,8.144329896907216,39.79381443298969,-31.649484536082475
81078,141,637,-496,1617,8.719851576994433,39.39393939393939,-30.674087816944958
81079,151,444,-293,1245,12.1285140562249,35.66265060240964,-23.53413654618474
81080,86,502,-416,1235,6.963562753036437,40.64777327935223,-33.684210526315795
81081,53,371,-318,874,6.064073226544623,42.44851258581236,-36.38443935926774
81082,71,329,-258,841,8.442330558858501,39.12009512485137,-30.677764565992867
81083,75,342,-267,871,8.610792192881746,39.26521239954076,-30.65442020665901
81084,122,580,-458,1463,8.33902939166097,39.64456596035543,-31.305536568694457
81085,50,217,-167,553,9.041591320072333,39.24050632911392,-30.198915009041585
81086,119,372,-253,1027,11.587147030185005,36.22200584225901,-24.634858812074004
81087,71,349,-278,881,8.059023836549375,39.61407491486947,-31.555051078320094
81088,128,294,-166,888,14.414414414414415,33.108108108108105,-18.69369369369369
81089,66,337,-271,826,7.990314769975787,40.79903147699758,-32.80871670702179
81090,46,371,-325,874,5.263157894736842,42.44851258581236,-37.18535469107552
81091,59,343,-284,829,7.117008443908324,41.3751507840772,-34.258142340168874
81092,15,321,-306,686,2.186588921282799,46.79300291545189,-44.606413994169095
81093,34,497,-463,1081,3.145235892691952,45.97594819611471,-42.83071230342276
81094,47,424,-377,955,4.9214659685863875,44.397905759162306,-39.47643979057592
81095,44,208,-164,536,8.208955223880597,38.80597014925373,-30.597014925373134
81096,41,311,-270,725,5.655172413793103,42.896551724137936,-37.24137931034483
81097,20,421,-401,915,2.185792349726776,46.01092896174863,-43.82513661202186
81098,35,398,-363,898,3.8975501113585747,44.32071269487751,-40.42316258351893
81099,67,588,-521,1364,4.912023460410557,43.10850439882698,-38.19648093841642
81100,18,386,-368,835,2.155688622754491,46.22754491017964,-44.07185628742515
81102,0,0,0,0,0.0,0.0,0.0
81103,0,0,0,0,0.0,0.0,0.0
81104,4,18,-14,46,8.695652173913043,39.130434782608695,-30.434782608695652
81105,0,0,0,0,0.0,0.0,0.0
81106,0,0,0,0,0.0,0.0,0.0
81107,2,84,-82,172,1.1627906976744187,48.837209302325576,-47.67441860465116
82001,366,157,209,1090,33.57798165137615,14.403669724770642,19.174311926605505
82002,318,238,80,1139,27.91922739244952,20.8955223880597,7.0237050043898215
82003,213,112,101,676,31.50887573964497,16.56804733727811,14.940828402366861
82004,318,168,150,1004,31.673306772908365,16.733067729083665,14.9402390438247
82005,295,354,-59,1338,22.04783258594918,26.45739910313901,-4.40956651718983
82006,187,284,-97,958,19.51983298538622,29.64509394572025,-10.125260960334032
82007,213,245,-32,958,22.233820459290186,25.5741127348643,-3.3402922755741145
82008,135,445,-310,1191,11.335012594458437,37.36356003358522,-26.028547439126786
82009,160,245,-85,830,19.27710843373494,29.518072289156628,-10.240963855421686
82010,187,488,-301,1394,13.414634146341465,35.00717360114778,-21.592539454806314
82011,148,347,-199,1024,14.453125,33.88671875,-19.43359375
82012,16,324,-308,693,2.3088023088023086,46.75324675324675,-44.44444444444444
82013,17,426,-409,887,1.9165727170236753,48.02705749718152,-46.11048478015784
82014,10,176,-166,380,2.631578947368421,46.31578947368421,-43.684210526315795
82015,26,470,-444,1014,2.564102564102564,46.35108481262327,-43.78698224852071
82016,136,312,-176,921,14.76655808903366,33.876221498371336,-19.109663409337678
82017,223,365,-142,1230,18.130081300813007,29.67479674796748,-11.544715447154474
82018,67,246,-179,632,10.601265822784809,38.924050632911396,-28.322784810126585
82019,118,206,-88,663,17.79788838612368,31.070889894419306,-13.273001508295625
82020,166,199,-33,768,21.614583333333336,25.911458333333332,-4.2968749999999964
82021,91,207,-116,606,15.016501650165019,34.15841584158416,-19.14191419141914
82022,158,352,-194,1047,15.090735434574976,33.61986628462273,-18.529130850047757
82023,51,408,-357,952,5.357142857142857,42.857142857142854,-37.5
82024,137,370,-233,1053,13.010446343779677,35.13770180436847,-22.127255460588792
82025,157,324,-167,992,15.826612903225806,32.66129032258064,-16.834677419354833
82026,0,0,0,0,0.0,0.0,0.0
82027,31,272,-241,618,5.016181229773463,44.01294498381877,-38.996763754045304
82028,61,521,-460,1193,5.113160100586756,43.67141659681476,-38.558256496228005
82029,25,126,-101,310,8.064516129032258,40.64516129032258,-32.58064516129032
82030,64,438,-374,1027,6.2317429406037,42.648490749756576,-36.416747809152874
82031,75,716,-641,1611,4.655493482309125,44.44444444444444,-39.78895096213532
82032,188,330,-142,1080,17.40740740740741,30.555555555555557,-13.148148148148149
82033,168,268,-100,910,18.461538461538463,29.450549450549453,-10.989010989010989
82034,134,240,-106,786,17.048346055979643,30.53435114503817,-13.486005089058526
82035,218,362,-144,1206,18.076285240464347,30.016583747927033,-11.940298507462686
82036,231,443,-212,1375,16.8,32.21818181818182,-15.418181818181818
82037,125,316,-191,901,13.873473917869033,35.07214206437292,-21.198668146503884
82038,91,335,-244,883,10.30577576443941,37.93884484711212,-27.633069082672712
82039,189,434,-245,1294,14.605873261205565,33.53941267387944,-18.933539412673873
82040,215,230,-15,909,23.652365236523654,25.302530253025303,-1.6501650165016493
82041,277,231,46,1040,26.634615384615383,22.21153846153846,4.423076923076923
82042,130,135,-5,556,23.381294964028775,24.280575539568343,-0.8992805755395672
82043,254,194,60,911,27.881448957189903,21.295279912184412,6.586169045005491
82044,257,210,47,967,26.5770423991727,21.71664943123061,4.86039296794209
82045,229,146,83,778,29.43444730077121,18.76606683804627,10.66838046272494
82046,267,173,94,920,29.02173913043478,18.804347826086957,10.217391304347824
82047,254,177,77,908,27.973568281938327,19.493392070484582,8.480176211453745
82048,291,208,83,1036,28.08880308880309,20.077220077220076,8.011583011583014
82049,375,215,160,1218,30.78817733990148,17.651888341543515,13.136288998357966
82050,91,212,-121,616,14.772727272727273,34.41558441558442,-19.642857142857146
82051,158,390,-232,1133,13.945278022947926,34.42188879082083,-20.476610767872906
82052,196,365,-169,1182,16.58206429780034,30.879864636209813,-14.297800338409473
82053,99,296,-197,827,11.970979443772672,35.79201934703748,-23.82103990326481
82054,1,49,-48,100,1.0,49.0,-48.0
82055,163,196,-33,742,21.96765498652291,26.41509433962264,-4.447439353099732
82056,163,255,-92,906,17.991169977924944,28.14569536423841,-10.154525386313466
82057,154,213,-59,763,20.18348623853211,27.916120576671034,-7.732634338138922
82058,213,218,-5,900,23.666666666666668,24.22222222222222,-0.5555555555555536
82059,5,25,-20,62,8.064516129032258,40.32258064516129,-32.25806451612903
82060,233,270,-37,1042,22.36084452975048,25.911708253358924,-3.550863723608444
82061,240,303,-63,1140,21.052631578947366,26.57894736842105,-5.526315789473685
82062,219,240,-21,975,22.46153846153846,24.615384615384617,-2.153846153846157
82063,183,236,-53,869,21.058688147295744,27.15765247410817,-6.098964326812425
82064,72,269,-197,703,10.241820768136558,38.26458036984353,-28.022759601706973
82065,57,725,-668,1601,3.560274828232355,45.284197376639604,-41.72392254840725
82066,40,365,-325,830,4.819277108433735,43.97590361445783,-39.15662650602409
82067,34,441,-407,957,3.5527690700104495,46.08150470219436,-42.52873563218391
82068,22,347,-325,746,2.949061662198391,46.51474530831099,-43.5656836461126
82069,29,376,-347,822,3.5279805352798053,45.742092457420924,-42.21411192214112
82070,23,319,-296,702,3.276353276353276,45.44159544159544,-42.16524216524216
82071,19,379,-360,807,2.3543990086741013,46.96406443618339,-44.60966542750929
82072,27,389,-362,848,3.1839622641509435,45.87264150943396,-42.68867924528302
82073,22,359,-337,779,2.8241335044929397,46.08472400513479,-43.26059050064185
82074,23,308,-285,683,3.3674963396778916,45.095168374816986,-41.72767203513909
82075,13,304,-291,640,2.03125,47.5,-45.46875
82076,14,312,-298,708,1.977401129943503,44.06779661016949,-42.090395480225986
82077,17,399,-382,852,1.9953051643192488,46.83098591549296,-44.83568075117371
82078,28,437,-409,939,2.9818956336528224,46.53887113951012,-43.556975505857295
82079,26,439,-413,954,2.7253668763102725,46.0167714884696,-43.291404612159326
82081,30,374,-344,824,3.640776699029126,45.38834951456311,-41.747572815533985
82082,21,250,-229,564,3.723404255319149,44.32624113475177,-40.60283687943262
82083,11,85,-74,194,5.670103092783505,43.81443298969072,-38.144329896907216
82084,27,480,-453,1031,2.6188166828322017,46.55674102812803,-43.937924345295826
82085,34,335,-301,757,4.491413474240423,44.253632760898284,-39.76221928665786
82086,21,330,-309,721,2.912621359223301,45.76976421636616,-42.85714285714286
82087,17,346,-329,736,2.309782608695652,47.01086956521739,-44.70108695652174
82088,15,388,-373,830,1.8072289156626504,46.74698795180723,-44.93975903614458
82089,28,406,-378,882,3.1746031746031744,46.03174603174603,-42.857142857142854
82090,30,361,-331,807,3.717472118959108,44.73358116480793,-41.01610904584882
82091,20,201,-181,448,4.464285714285714,44.86607142857143,-40.401785714285715
82092,34,491,-457,1067,3.1865042174320526,46.01686972820993,-42.83036551077788
82093,27,374,-347,814,3.3169533169533167,45.94594594594595,-42.628992628992634
82094,20,373,-353,811,2.466091245376079,45.99260172626387,-43.526510480887794
82095,31,502,-471,1091,2.841429880843263,46.012832263978005,-43.17140238313474
82096,22,326,-304,717,3.0683403068340307,45.467224546722456,-42.398884239888424
82097,43,400,-357,900,4.777777777777778,44.44444444444444,-39.666666666666664
82098,42,473,-431,1050,4.0,45.04761904761905,-41.04761904761905
82099,16,444,-428,947,1.689545934530095,46.884899683210136,-45.19535374868004
82100,29,386,-357,853,3.399765533411489,45.25205158264947,-41.85228604923798
82101,15,363,-348,767,1.955671447196871,47.327249022164274,-45.371577574967404
82102,18,347,-329,745,2.4161073825503356,46.577181208053695,-44.16107382550336
82103,19,310,-291,673,2.823179791976226,46.062407132243685,-43.23922734026746
82104,18,420,-402,894,2.013422818791946,46.97986577181208,-44.966442953020135
82105,25,408,-383,880,2.840909090909091,46.36363636363636,-43.522727272727266
82106,1,0,1,4,25.0,0.0,25.0
82107,74,131,-57,423,17.494089834515368,30.969267139479907,-13.47517730496454
82108,0,1,-1,2,0.0,50.0,-50.0
82109,36,237,-201,558,6.451612903225806,42.473118279569896,-36.02150537634409
82111,0,0,0,0,0.0,0.0,0.0
82117,0,0,0,0,0.0,0.0,0.0
83001,35,676,-641,1470,2.380952380952381,45.98639455782313,-43.60544217687075
83002,5,95,-90,200,2.5,47.5,-45.0
83003,14,361,-347,757,1.8494055482166447,47.6882430647292,-45.838837516512555
83004,15,201,-186,446,3.3632286995515694,45.06726457399103,-41.70403587443946
83005,6,110,-104,239,2.510460251046025,46.02510460251046,-43.51464435146443
83006,18,455,-437,956,1.882845188284519,47.59414225941423,-45.71129707112971
83007,10,504,-494,1051,0.9514747859181731,47.95432921027592,-47.00285442435775
83008,16,353,-337,757,2.1136063408190227,46.63143989431968,-44.51783355350066
83009,13,407,-394,850,1.5294117647058825,47.88235294117647,-46.35294117647059
83010,20,692,-672,1436,1.392757660167131,48.18941504178273,-46.7966573816156
83011,20,506,-486,1065,1.8779342723004695,47.51173708920188,-45.63380281690141
83013,24,639,-615,1348,1.7804154302670623,47.403560830860535,-45.62314540059347
83014,23,747,-724,1580,1.4556962025316456,47.27848101265823,-45.822784810126585
83015,15,611,-596,1280,1.171875,47.734375,-46.5625
83016,9,583,-574,1197,0.7518796992481203,48.705096073517126,-47.953216374269005
83017,9,500,-491,1028,0.8754863813229572,48.63813229571984,-47.762645914396884
83018,11,495,-484,1035,1.0628019323671498,47.82608695652174,-46.76328502415459
83019,14,394,-380,836,1.674641148325359,47.12918660287082,-45.45454545454546
83020,6,392,-386,809,0.7416563658838072,48.4548825710754,-47.713226205191596
83021,12,446,-434,925,1.2972972972972971,48.21621621621622,-46.91891891891892
83022,20,407,-387,878,2.277904328018223,46.35535307517084,-44.077448747152616
83023,14,403,-389,859,1.629802095459837,46.91501746216531,-45.28521536670547
83024,7,226,-219,484,1.4462809917355373,46.69421487603306,-45.247933884297524
83025,10,378,-368,792,1.2626262626262625,47.72727272727273,-46.464646464646464
83026,15,270,-255,579,2.5906735751295336,46.63212435233161,-44.04145077720207
83027,31,547,-516,1171,2.6473099914602902,46.712211784799315,-44.064901793339025
83028,24,632,-608,1342,1.7883755588673622,47.093889716840536,-45.30551415797317
83029,18,363,-345,768,2.34375,47.265625,-44.921875
83030,26,442,-416,955,2.7225130890052354,46.282722513089006,-43.56020942408377
83031,13,484,-471,1006,1.2922465208747516,48.111332007952285,-46.81908548707754
83032,17,539,-522,1127,1.5084294587400178,47.82608695652174,-46.317657497781724
83033,19,466,-447,987,1.9250253292806485,47.21377912867275,-45.2887537993921
83034,14,540,-526,1118,1.2522361359570662,48.3005366726297,-47.04830053667263
83035,19,408,-389,868,2.1889400921658986,47.004608294930875,-44.815668202764975
83036,15,243,-228,518,2.8957528957528957,46.91119691119691,-44.01544401544402
83037,5,441,-436,898,0.5567928730512249,49.10913140311804,-48.55233853006682
83038,13,507,-494,1061,1.2252591894439209,47.78510838831291,-46.559849198868996
83039,15,427,-412,899,1.668520578420467,47.4972191323693,-45.82869855394883
83040,8,379,-371,781,1.0243277848911652,48.52752880921895,-47.50320102432779
83041,12,364,-352,761,1.5768725361366622,47.83180026281209,-46.254927726675426
83042,12,457,-445,949,1.2644889357218125,48.15595363540569,-46.89146469968387
83043,8,425,-417,881,0.9080590238365494,48.240635641316686,-47.332576617480136
83044,13,547,-534,1137,1.1433597185576077,48.10905892700088,-46.965699208443276
83045,13,546,-533,1129,1.1514614703277237,48.36138175376439,-47.20992028343667
83046,25,423,-398,914,2.735229759299781,46.2800875273523,-43.544857768052516
83047,23,428,-405,917,2.5081788440567068,46.673936750272624,-44.165757906215916
83048,13,442,-429,922,1.4099783080260302,47.939262472885034,-46.52928416485901
83049,14,437,-423,910,1.5384615384615385,48.02197802197802,-46.48351648351648
83050,22,538,-516,1136,1.936619718309859,47.359154929577464,-45.42253521126761
83051,10,512,-502,1056,0.946969696969697,48.484848484848484,-47.53787878787879
83052,18,518,-500,1090,1.651376146788991,47.522935779816514,-45.87155963302752
83053,14,435,-421,911,1.5367727771679474,47.74972557628979,-46.212952799121844
83054,10,384,-374,796,1.256281407035176,48.24120603015075,-46.984924623115575
83055,11,554,-543,1141,0.9640666082383873,48.55390008764242,-47.58983347940403
83056,19,524,-505,1104,1.7210144927536233,47.46376811594203,-45.742753623188406
83057,12,468,-456,980,1.2244897959183674,47.755102040816325,-46.53061224489796
83058,7,335,-328,694,1.0086455331412103,48.27089337175792,-47.26224783861671
83059,16,553,-537,1160,1.3793103448275863,47.672413793103445,-46.29310344827586
83060,15,214,-199,463,3.2397408207343417,46.220302375809936,-42.980561555075596
83061,6,325,-319,684,0.8771929824561403,47.514619883040936,-46.6374269005848
83062,6,261,-255,548,1.094890510948905,47.627737226277375,-46.53284671532847
83063,10,343,-333,720,1.3888888888888888,47.638888888888886,-46.25
83064,12,419,-407,874,1.3729977116704806,47.94050343249428,-46.5675057208238
83065,12,359,-347,747,1.6064257028112447,48.058902275769746,-46.4524765729585
83066,25,562,-537,1189,2.1026072329688814,47.26661059714045,-45.16400336417157
83067,25,606,-581,1299,1.924557351809084,46.65127020785219,-44.72671285604311
83068,0,1,-1,2,0.0,50.0,-50.0
83069,24,717,-693,1518,1.5810276679841897,47.233201581027664,-45.65217391304348
83070,46,576,-530,1265,3.6363636363636362,45.533596837944664,-41.89723320158103
83071,30,574,-544,1229,2.4410089503661516,46.7046379170057,-44.263628966639544
83072,19,365,-346,793,2.3959646910466583,46.02774274905423,-43.63177805800757
83073,13,506,-493,1045,1.244019138755981,48.421052631578945,-47.177033492822964
83074,33,502,-469,1090,3.0275229357798166,46.055045871559635,-43.02752293577982
83075,24,569,-545,1207,1.9884009942004972,47.14167357083679,-45.15327257663629
83076,26,575,-549,1220,2.1311475409836063,47.13114754098361,-45.00000000000001
83077,11,484,-473,1007,1.0923535253227408,48.0635551142006,-46.971201588877854
83078,16,406,-390,866,1.8475750577367205,46.88221709006928,-45.03464203233256
83079,22,629,-607,1341,1.6405667412378822,46.90529455630127,-45.26472781506339
83080,14,462,-448,970,1.443298969072165,47.62886597938144,-46.18556701030927
83081,24,574,-550,1209,1.9851116625310175,47.47725392886683,-45.49214226633581
83082,19,541,-522,1133,1.6769638128861428,47.74933804060018,-46.072374227714036
83083,25,477,-452,1020,2.450980392156863,46.76470588235294,-44.31372549019608
83084,5,46,-41,104,4.807692307692308,44.230769230769226,-39.42307692307692
83085,12,244,-232,525,2.2857142857142856,46.476190476190474,-44.19047619047619
83086,17,298,-281,637,2.6687598116169546,46.781789638932494,-44.11302982731554
84001,28,550,-522,1171,2.391118701964133,46.96840307429547,-44.57728437233134
84002,22,528,-506,1115,1.9730941704035874,47.3542600896861,-45.381165919282516
84003,27,523,-496,1115,2.4215246636771304,46.90582959641256,-44.48430493273543
84004,18,501,-483,1059,1.69971671388102,47.30878186968839,-45.60906515580737
84005,28,456,-428,994,2.8169014084507045,45.87525150905433,-43.058350100603626
84006,26,571,-545,1219,2.1328958162428218,46.8416735028712,-44.70877768662838
84007,23,500,-477,1062,2.1657250470809792,47.080979284369114,-44.91525423728814
84008,40,706,-666,1510,2.6490066225165565,46.75496688741722,-44.10596026490066
84009,22,363,-341,785,2.802547770700637,46.24203821656051,-43.439490445859875
84010,18,549,-531,1150,1.565217391304348,47.73913043478261,-46.17391304347826
84011,24,571,-547,1217,1.9720624486442069,46.91865242399343,-44.94658997534922
84012,20,416,-396,892,2.242152466367713,46.63677130044843,-44.39461883408072
84013,31,532,-501,1145,2.7074235807860263,46.46288209606987,-43.75545851528384
84014,34,473,-439,1051,3.2350142721217887,45.00475737392959,-41.769743101807805
84015,12,293,-281,617,1.9448946515397085,47.487844408427875,-45.54294975688817
84016,27,655,-628,1395,1.935483870967742,46.95340501792115,-45.017921146953405
84017,8,189,-181,404,1.9801980198019802,46.78217821782179,-44.801980198019805
84018,6,129,-123,276,2.1739130434782608,46.73913043478261,-44.56521739130435
84019,21,501,-480,1049,2.001906577693041,47.75977121067683,-45.75786463298379
84020,15,449,-434,963,1.557632398753894,46.625129802699895,-45.067497403946
84021,0,75,-75,158,0.0,47.46835443037975,-47.46835443037975
84022,12,112,-100,255,4.705882352941177,43.92156862745098,-39.21568627450981
84023,17,500,-483,1049,1.6205910390848426,47.66444232602478,-46.04385128693994
84024,26,422,-396,920,2.8260869565217392,45.869565217391305,-43.04347826086956
84025,22,530,-508,1140,1.9298245614035088,46.49122807017544,-44.56140350877193
84026,7,207,-200,433,1.6166281755196306,47.80600461893764,-46.18937644341801
84027,6,283,-277,588,1.0204081632653061,48.12925170068027,-47.10884353741496
84028,28,613,-585,1293,2.165506573859242,47.409126063418405,-45.243619489559165
84029,11,364,-353,769,1.4304291287386215,47.33420026007803,-45.903771131339404
84030,10,295,-285,621,1.610305958132045,47.50402576489533,-45.893719806763286
84031,8,266,-258,557,1.436265709156194,47.755834829443444,-46.31956912028725
84032,4,248,-244,508,0.7874015748031495,48.818897637795274,-48.031496062992126
84033,23,377,-354,818,2.8117359413202934,46.0880195599022,-43.27628361858191
84034,28,610,-582,1294,2.1638330757341575,47.14064914992272,-44.97681607418856
84035,24,372,-348,807,2.973977695167286,46.09665427509294,-43.12267657992565
84036,5,153,-148,316,1.5822784810126582,48.41772151898734,-46.835443037974684
84037,20,405,-385,865,2.312138728323699,46.82080924855491,-44.508670520231206
84038,33,411,-378,928,3.556034482758621,44.28879310344828,-40.73275862068966
84039,46,504,-458,1130,4.070796460176991,44.60176991150443,-40.530973451327434
84040,19,465,-446,992,1.9153225806451613,46.875,-44.95967741935484
84041,29,395,-366,869,3.33716915995397,45.45454545454545,-42.11737629459148
84042,20,479,-459,1020,1.9607843137254901,46.96078431372549,-45.0
84043,22,431,-409,920,2.391304347826087,46.84782608695652,-44.45652173913044
84044,20,423,-403,901,2.2197558268590454,46.94783573806881,-44.72807991120977
84045,24,341,-317,736,3.260869565217391,46.33152173913043,-43.07065217391304
84046,20,357,-337,770,2.5974025974025974,46.36363636363636,-43.76623376623376
84047,7,167,-160,370,1.891891891891892,45.13513513513514,-43.24324324324324
84048,42,405,-363,912,4.605263157894736,44.40789473684211,-39.80263157894737
84049,12,186,-174,421,2.8503562945368173,44.180522565320665,-41.33016627078385
84050,19,349,-330,768,2.473958333333333,45.44270833333333,-42.96874999999999
84051,35,773,-738,1638,2.1367521367521367,47.19169719169719,-45.05494505494505
84052,26,556,-530,1183,2.197802197802198,46.99915469146239,-44.80135249366019
84053,0,0,0,0,0.0,0.0,0.0
84054,29,444,-415,966,3.002070393374741,45.962732919254655,-42.96066252587991
84055,28,419,-391,914,3.063457330415755,45.842450765864335,-42.778993435448584
84056,14,439,-425,930,1.5053763440860215,47.204301075268816,-45.69892473118279
84057,30,456,-426,995,3.015075376884422,45.82914572864322,-42.8140703517588
84058,34,420,-386,937,3.628601921024546,44.823906083244395,-41.19530416221985
84059,20,450,-430,971,2.059732234809475,46.34397528321318,-44.28424304840371
84060,30,378,-348,839,3.575685339690107,45.05363528009535,-41.47794994040524
84061,15,431,-416,910,1.6483516483516485,47.36263736263736,-45.71428571428571
84062,18,353,-335,760,2.368421052631579,46.44736842105263,-44.07894736842105
84063,8,362,-354,765,1.045751633986928,47.32026143790849,-46.27450980392156
84064,26,537,-511,1143,2.2747156605424323,46.981627296587924,-44.70691163604549
84065,17,383,-366,822,2.068126520681265,46.59367396593674,-44.52554744525547
84066,34,504,-470,1097,3.099361896080219,45.94348222424795,-42.84412032816773
84067,16,364,-348,776,2.0618556701030926,46.90721649484536,-44.845360824742265
84068,9,367,-358,770,1.1688311688311688,47.66233766233766,-46.493506493506494
84069,18,207,-189,459,3.9215686274509802,45.09803921568628,-41.1764705882353
84070,7,229,-222,485,1.443298969072165,47.21649484536082,-45.77319587628865
84071,48,515,-467,1136,4.225352112676056,45.33450704225352,-41.109154929577464
84072,37,506,-469,1110,3.3333333333333335,45.585585585585584,-42.25225225225225
84073,4,115,-111,245,1.6326530612244898,46.93877551020408,-45.30612244897959
84074,30,453,-423,1002,2.9940119760479043,45.209580838323355,-42.21556886227545
84075,25,403,-378,870,2.8735632183908044,46.32183908045977,-43.44827586206896
84076,5,43,-38,101,4.9504950495049505,42.57425742574257,-37.62376237623762
84077,14,373,-359,787,1.7789072426937738,47.39517153748412,-45.61626429479034
84078,2,108,-106,220,0.9090909090909091,49.09090909090909,-48.18181818181819
84079,1,4,-3,10,10.0,40.0,-30.0
84080,18,438,-420,936,1.9230769230769231,46.794871794871796,-44.871794871794876
85001,28,579,-551,1247,2.245388933440257,46.43143544506817,-44.18604651162791
85002,38,427,-389,963,3.9460020768431985,44.34060228452752,-40.39460020768432
85003,60,560,-500,1272,4.716981132075472,44.0251572327044,-39.30817610062893
85004,43,416,-373,936,4.594017094017095,44.44444444444444,-39.850427350427346
85005,46,486,-440,1099,4.185623293903549,44.22202001819836,-40.03639672429481
85006,29,250,-221,575,5.043478260869565,43.47826086956522,-38.434782608695656
85007,39,413,-374,920,4.239130434782608,44.891304347826086,-40.65217391304348
85008,44,542,-498,1203,3.657522859517872,45.05403158769742,-41.396508728179555
85009,22,326,-304,711,3.0942334739803097,45.85091420534459,-42.75668073136428
85010,19,382,-363,812,2.3399014778325125,47.04433497536946,-44.70443349753695
85011,14,489,-475,1020,1.3725490196078431,47.94117647058824,-46.568627450980394
85012,24,549,-525,1168,2.054794520547945,47.00342465753425,-44.9486301369863
85013,7,510,-503,1065,0.6572769953051643,47.88732394366197,-47.2300469483568
85014,11,298,-287,627,1.7543859649122806,47.52791068580542,-45.77352472089314
85015,24,465,-441,1000,2.4,46.5,-44.1
85016,4,273,-269,563,0.7104795737122558,48.49023090586146,-47.7797513321492
85017,8,421,-413,866,0.9237875288683602,48.61431870669746,-47.6905311778291
85018,9,20,-11,62,14.516129032258066,32.25806451612903,-17.741935483870968
85019,8,587,-579,1204,0.6644518272425249,48.754152823920265,-48.08970099667774
85020,18,512,-494,1082,1.6635859519408502,47.31977818853974,-45.65619223659889
85021,14,521,-507,1083,1.2927054478301014,48.10710987996307,-46.81440443213297
85022,18,390,-372,827,2.176541717049577,47.15840386940749,-44.98186215235792
85023,6,314,-308,643,0.9331259720062209,48.83359253499223,-47.900466562986004
85024,19,544,-525,1154,1.6464471403812824,47.14038128249567,-45.493934142114384
85025,17,595,-578,1253,1.3567438148443736,47.486033519553075,-46.129289704708704
85026,22,419,-397,908,2.4229074889867843,46.14537444933921,-43.72246696035242
85027,23,241,-218,538,4.275092936802974,44.795539033457246,-40.52044609665427
85028,1,57,-56,118,0.847457627118644,48.30508474576271,-47.45762711864407
85029,11,336,-325,701,1.5691868758915835,47.93152639087018,-46.3623395149786
85030,16,434,-418,917,1.7448200654307526,47.32824427480916,-45.58342420937841
85031,14,514,-500,1080,1.2962962962962963,47.592592592592595,-46.2962962962963
85032,47,556,-509,1232,3.8149350649350646,45.12987012987013,-41.314935064935064
85033,31,460,-429,1013,3.0602171767028628,45.409674234945705,-42.34945705824284
85034,18,402,-384,849,2.1201413427561837,47.349823321554766,-45.22968197879858
85035,0,0,0,0,0.0,0.0,0.0
85036,3,71,-68,148,2.027027027027027,47.97297297297297,-45.945945945945944
85037,11,528,-517,1089,1.0101010101010102,48.484848484848484,-47.474747474747474
85038,7,344,-337,724,0.9668508287292817,47.51381215469613,-46.54696132596685
85039,19,524,-505,1099,1.7288444040036397,47.67970882620564,-45.950864422202
85040,13,258,-245,557,2.333931777378815,46.319569120287255,-43.98563734290844
85041,38,542,-504,1169,3.2506415739948675,46.364414029084685,-43.113772455089816
85042,20,380,-360,822,2.4330900243309004,46.228710462287104,-43.7956204379562
85043,35,314,-279,710,4.929577464788732,44.225352112676056,-39.29577464788733
85044,17,382,-365,813,2.091020910209102,46.98646986469865,-44.895448954489545
85045,38,510,-472,1116,3.405017921146954,45.69892473118279,-42.293906810035836
85046,12,322,-310,677,1.7725258493353029,47.56277695716396,-45.79025110782866
85047,23,402,-379,879,2.6166097838452784,45.73378839590443,-43.117178612059156
85048,32,440,-408,967,3.3092037228541886,45.501551189245085,-42.1923474663909
85049,34,588,-554,1266,2.6856240126382307,46.44549763033176,-43.75987361769353
85050,23,467,-444,1001,2.2977022977022976,46.65334665334665,-44.35564435564436
85051,19,334,-315,722,2.631578947368421,46.26038781163435,-43.628808864265935
85052,21,466,-445,983,2.136317395727365,47.4059003051882,-45.26958290946083
85053,31,473,-442,1043,2.972195589645254,45.349952061361456,-42.377756471716204
85054,41,453,-412,1013,4.047384007897334,44.71865745310958,-40.67127344521224
85055,39,565,-526,1235,3.1578947368421053,45.74898785425101,-42.59109311740891
85056,12,216,-204,458,2.6200873362445414,47.161572052401745,-44.5414847161572
85057,22,346,-324,756,2.91005291005291,45.767195767195766,-42.857142857142854
85058,28,494,-466,1067,2.6241799437675724,46.29803186504217,-43.6738519212746
85059,36,572,-536,1236,2.912621359223301,46.27831715210356,-43.36569579288026
85060,17,381,-364,806,2.109181141439206,47.270471464019856,-45.16129032258065
85061,20,245,-225,541,3.6968576709796674,45.28650646950093,-41.58964879852126
85062,28,475,-447,1043,2.684563758389262,45.54170661553212,-42.85714285714286
85063,28,439,-411,944,2.9661016949152543,46.50423728813559,-43.53813559322034
85064,18,452,-434,957,1.8808777429467085,47.23092998955068,-45.35005224660397
85065,24,547,-523,1174,2.0442930153321974,46.592844974446336,-44.548551959114135
85066,39,519,-480,1132,3.4452296819787986,45.84805653710247,-42.40282685512367
85067,21,418,-397,898,2.338530066815145,46.5478841870824,-44.20935412026726
85068,38,505,-467,1105,3.4389140271493215,45.70135746606335,-42.262443438914026
85069,16,495,-479,1036,1.5444015444015444,47.77992277992278,-46.23552123552123
85070,19,356,-337,759,2.503293807641634,46.9038208168643,-44.400527009222664
85071,0,0,0,0,0.0,0.0,0.0
85072,0,0,0,0,0.0,0.0,0.0
85073,0,0,0,0,0.0,0.0,0.0
85076,0,0,0,0,0.0,0.0,0.0
85077,0,0,0,0,0.0,0.0,0.0
85079,0,0,0,0,0.0,0.0,0.0
85080,13,180,-167,392,3.316326530612245,45.91836734693878,-42.602040816326536
85081,12,391,-379,822,1.4598540145985401,47.5669099756691,-46.10705596107056
85082,19,283,-264,618,3.074433656957929,45.79288025889968,-42.71844660194175
86001,14,587,-573,1221,1.1466011466011465,48.075348075348074,-46.928746928746925
86002,21,524,-503,1114,1.8850987432675044,47.03770197486535,-45.152603231597844
86003,22,366,-344,789,2.788339670468948,46.38783269961977,-43.59949302915082
86004,21,306,-285,659,3.1866464339908953,46.4339908952959,-43.247344461305005
86005,11,320,-309,673,1.634472511144131,47.5482912332838,-45.913818722139666
86006,17,413,-396,868,1.9585253456221197,47.58064516129033,-45.622119815668206
86007,19,406,-387,861,2.2067363530778166,47.15447154471545,-44.94773519163763
86008,28,596,-568,1255,2.2310756972111556,47.49003984063745,-45.2589641434263
86009,14,480,-466,999,1.4014014014014013,48.048048048048045,-46.646646646646644
86010,18,333,-315,717,2.510460251046025,46.44351464435147,-43.93305439330544
86011,17,378,-361,804,2.1144278606965177,47.01492537313433,-44.900497512437816
86012,38,500,-462,1100,3.4545454545454546,45.45454545454545,-42.0
86013,23,541,-518,1146,2.006980802792321,47.20767888307155,-45.20069808027923
86014,32,556,-524,1199,2.6688907422852375,46.371976647206004,-43.70308590492077
86015,21,489,-468,1043,2.013422818791946,46.88398849472675,-44.870565675934806
86016,24,602,-578,1286,1.8662519440124419,46.81181959564541,-44.94556765163297
86017,27,486,-459,1050,2.571428571428571,46.285714285714285,-43.714285714285715
86018,27,510,-483,1105,2.4434389140271495,46.15384615384615,-43.710407239819006
86019,30,445,-415,974,3.0800821355236137,45.687885010266946,-42.607802874743335
86020,35,600,-565,1312,2.667682926829268,45.73170731707317,-43.06402439024391
86021,2,65,-63,135,1.4814814814814816,48.148148148148145,-46.666666666666664
86022,19,485,-466,1049,1.811248808388942,46.23450905624404,-44.423260247855104
86023,19,360,-341,787,2.41423125794155,45.7433290978399,-43.329097839898346
86024,32,553,-521,1194,2.680067001675042,46.31490787269682,-43.63484087102178
86025,15,439,-424,926,1.6198704103671708,47.40820734341253,-45.78833693304536
86026,23,415,-392,884,2.6018099547511313,46.94570135746606,-44.34389140271493
86027,25,396,-371,860,2.9069767441860463,46.04651162790698,-43.139534883720934
86028,23,445,-422,960,2.3958333333333335,46.35416666666667,-43.958333333333336
86029,21,476,-455,1005,2.0895522388059704,47.363184079601986,-45.273631840796014
86030,31,363,-332,818,3.7897310513447433,44.37652811735941,-40.58679706601467
86031,24,399,-375,864,2.7777777777777777,46.18055555555556,-43.40277777777778
86032,18,489,-471,1032,1.744186046511628,47.383720930232556,-45.63953488372093
86033,19,495,-476,1057,1.7975402081362346,46.830652790917696,-45.03311258278146
86034,21,601,-580,1262,1.664025356576862,47.622820919175915,-45.95879556259905
86035,23,594,-571,1250,1.8399999999999999,47.52,-45.68000000000001
86036,31,571,-540,1224,2.5326797385620914,46.650326797385624,-44.117647058823536
86037,28,490,-462,1067,2.6241799437675724,45.923149015932516,-43.298969072164944
86038,11,220,-209,477,2.3060796645702304,46.12159329140461,-43.815513626834374
86039,21,360,-339,779,2.6957637997432604,46.21309370988447,-43.51732991014121
86040,26,528,-502,1128,2.304964539007092,46.808510638297875,-44.50354609929078
86041,17,403,-386,862,1.9721577726218096,46.75174013921114,-44.779582366589324
86042,1,9,-8,20,5.0,45.0,-40.0
86043,2,116,-114,242,0.8264462809917356,47.93388429752066,-47.107438016528924
86044,11,178,-167,382,2.8795811518324608,46.596858638743456,-43.717277486910994
86045,21,415,-394,885,2.3728813559322033,46.89265536723164,-44.51977401129944
86046,11,425,-414,877,1.2542759407069555,48.46066134549601,-47.20638540478905
86047,18,691,-673,1450,1.2413793103448276,47.6551724137931,-46.41379310344828
86048,21,330,-309,725,2.896551724137931,45.51724137931035,-42.62068965517242
86049,27,484,-457,1055,2.5592417061611377,45.87677725118483,-43.317535545023695
86050,19,519,-500,1090,1.743119266055046,47.61467889908257,-45.87155963302752
86051,13,424,-411,890,1.4606741573033708,47.640449438202246,-46.17977528089887
86052,26,485,-459,1047,2.483285577841452,46.32282712511939,-43.83954154727794
86053,18,384,-366,824,2.1844660194174756,46.601941747572816,-44.41747572815534
86054,23,600,-577,1258,1.8282988871224166,47.69475357710652,-45.8664546899841
86055,25,475,-450,1032,2.422480620155039,46.02713178294574,-43.604651162790695
86056,44,518,-474,1142,3.852889667250438,45.359019264448335,-41.5061295971979
86057,24,424,-400,913,2.628696604600219,46.440306681270535,-43.81161007667031
86058,32,468,-436,1014,3.155818540433925,46.15384615384615,-42.998027613412226
86059,33,464,-431,1015,3.251231527093596,45.714285714285715,-42.46305418719212
86060,0,40,-40,80,0.0,50.0,-50.0
86061,19,314,-295,684,2.7777777777777777,45.90643274853801,-43.12865497076023
86062,21,353,-332,757,2.7741083223249667,46.63143989431968,-43.85733157199472
86063,24,452,-428,977,2.456499488229273,46.264073694984646,-43.807574206755376
86064,24,462,-438,995,2.4120603015075375,46.4321608040201,-44.02010050251256
86065,17,227,-210,496,3.4274193548387095,45.766129032258064,-42.33870967741935
86066,16,287,-271,620,2.5806451612903225,46.29032258064516,-43.70967741935484
86067,25,443,-418,963,2.596053997923157,46.00207684319834,-43.40602284527518
87001,2,68,-66,145,1.3793103448275863,46.89655172413793,-45.51724137931034
87002,14,393,-379,842,1.66270783847981,46.67458432304038,-45.01187648456057
87003,9,210,-201,454,1.9823788546255507,46.25550660792951,-44.27312775330396
87004,20,449,-429,955,2.094240837696335,47.01570680628272,-44.92146596858639
87005,12,315,-303,665,1.8045112781954888,47.368421052631575,-45.563909774436084
87006,32,469,-437,1034,3.0947775628626695,45.357833655705996,-42.26305609284333
87007,14,350,-336,742,1.8867924528301887,47.16981132075472,-45.28301886792453
87008,12,314,-302,671,1.7883755588673622,46.79582712369598,-45.007451564828614
87009,25,394,-369,863,2.8968713789107765,45.65469293163383,-42.75782155272306
87010,39,591,-552,1278,3.051643192488263,46.244131455399064,-43.1924882629108
87011,12,357,-345,751,1.5978695073235687,47.53661784287617,-45.9387483355526
87013,15,159,-144,355,4.225352112676056,44.7887323943662,-40.563380281690144
87014,9,155,-146,335,2.6865671641791042,46.26865671641791,-43.582089552238806
87015,4,164,-160,340,1.1764705882352942,48.23529411764706,-47.05882352941176
87016,12,131,-119,287,4.181184668989547,45.64459930313589,-41.463414634146346
87017,19,165,-146,377,5.039787798408488,43.76657824933687,-38.72679045092838
87018,33,405,-372,892,3.6995515695067267,45.403587443946186,-41.70403587443946
87019,39,425,-386,942,4.140127388535031,45.11677282377919,-40.976645435244166
87020,48,421,-373,966,4.968944099378882,43.581780538302276,-38.612836438923395
87021,2,85,-83,180,1.1111111111111112,47.22222222222222,-46.11111111111111
87022,15,266,-251,572,2.6223776223776225,46.50349650349651,-43.88111888111889
87023,44,511,-467,1136,3.873239436619718,44.982394366197184,-41.109154929577464
87024,21,243,-222,543,3.867403314917127,44.751381215469614,-40.88397790055249
87025,8,206,-198,435,1.839080459770115,47.356321839080465,-45.51724137931035
87026,41,499,-458,1101,3.7238873751135335,45.322434150772025,-41.59854677565849
87027,23,289,-266,645,3.565891472868217,44.8062015503876,-41.24031007751938
87028,35,502,-467,1096,3.1934306569343067,45.8029197080292,-42.6094890510949
87029,39,312,-273,738,5.284552845528456,42.27642276422765,-36.991869918699194
87030,12,161,-149,350,3.428571428571429,46.0,-42.57142857142857
87031,18,313,-295,676,2.6627218934911245,46.30177514792899,-43.63905325443787
87032,38,509,-471,1108,3.429602888086643,45.938628158844764,-42.50902527075812
87033,31,547,-516,1183,2.6204564666103125,46.23837700760778,-43.61792054099747
87034,51,478,-427,1078,4.7309833024118735,44.34137291280148,-39.61038961038961
87035,30,430,-400,941,3.1880977683315623,45.69606801275239,-42.50797024442083
87036,44,494,-450,1110,3.963963963963964,44.5045045045045,-40.54054054054054
87037,59,614,-555,1364,4.325513196480939,45.01466275659824,-40.6891495601173
87038,31,601,-570,1295,2.393822393822394,46.40926640926641,-44.01544401544401
87039,64,648,-584,1453,4.40467997247075,44.597384721266344,-40.19270474879559
87040,62,671,-609,1493,4.152712659075687,44.9430676490288,-40.79035498995311
87041,31,261,-230,594,5.218855218855219,43.93939393939394,-38.72053872053872
87042,27,491,-464,1053,2.564102564102564,46.628679962013294,-44.06457739791073
87043,1,0,1,2,50.0,0.0,50.0
87044,23,99,-76,251,9.163346613545817,39.44223107569721,-30.27888446215139
87045,17,55,-38,146,11.643835616438356,37.67123287671233,-26.027397260273975
87046,56,452,-396,1041,5.379442843419788,43.41978866474543,-38.040345821325644
87047,45,744,-699,1604,2.8054862842892767,46.38403990024938,-43.578553615960104
87048,18,504,-486,1072,1.6791044776119404,47.01492537313433,-45.33582089552239
87049,66,786,-720,1740,3.793103448275862,45.17241379310345,-41.37931034482759
87050,16,305,-289,652,2.4539877300613497,46.77914110429448,-44.32515337423313
87051,18,446,-428,940,1.9148936170212765,47.4468085106383,-45.53191489361702
87052,33,536,-503,1169,2.8229255774165956,45.85115483319076,-43.028229255774164
87053,56,720,-664,1585,3.533123028391167,45.42586750788644,-41.89274447949527
87054,76,745,-669,1683,4.515745692216281,44.26619132501485,-39.750445632798574
87055,43,490,-447,1091,3.9413382218148487,44.91292392300642,-40.97158570119157
87056,57,572,-515,1291,4.415182029434547,44.306738962044925,-39.89155693261038
87057,56,670,-614,1473,3.801765105227427,45.48540393754243,-41.683638832315005
87058,27,523,-496,1113,2.4258760107816713,46.99011680143755,-44.56424079065588
87059,48,678,-630,1475,3.2542372881355934,45.96610169491526,-42.71186440677967
87060,16,300,-284,648,2.4691358024691357,46.2962962962963,-43.827160493827165
87061,32,594,-562,1271,2.5177025963808024,46.734854445318646,-44.217151848937846
87062,36,634,-598,1376,2.616279069767442,46.075581395348834,-43.45930232558139
87063,8,45,-37,106,7.547169811320755,42.45283018867924,-34.90566037735849
87064,0,2,-2,4,0.0,50.0,-50.0
87065,49,290,-241,698,7.020057306590258,41.54727793696275,-34.52722063037249
87066,33,379,-346,847,3.896103896103896,44.74616292798111,-40.850059031877215
87067,35,309,-274,767,4.563233376792699,40.28683181225554,-35.72359843546285
87068,64,624,-560,1408,4.545454545454546,44.31818181818182,-39.77272727272727
87069,49,393,-344,916,5.349344978165939,42.903930131004365,-37.55458515283843
87070,17,457,-440,965,1.7616580310880827,47.35751295336787,-45.59585492227979
87071,16,257,-241,560,2.857142857142857,45.89285714285714,-43.035714285714285
87072,44,311,-267,722,6.094182825484765,43.07479224376731,-36.98060941828255
87073,4,59,-55,132,3.0303030303030303,44.696969696969695,-41.666666666666664
87074,64,489,-425,1129,5.66873339238264,43.312666076173606,-37.643932683790965
87075,40,379,-339,858,4.662004662004662,44.17249417249417,-39.510489510489506
87076,63,383,-320,915,6.885245901639345,41.857923497267755,-34.97267759562841
87077,41,433,-392,967,4.239917269906929,44.777662874870735,-40.5377456049638
87078,50,504,-454,1144,4.370629370629371,44.05594405594406,-39.68531468531469
87079,7,127,-120,279,2.5089605734767026,45.51971326164875,-43.01075268817205
87080,35,347,-312,775,4.516129032258064,44.774193548387096,-40.25806451612903
87081,35,389,-354,863,4.055619930475087,45.07531865585168,-41.01969872537659
87082,17,302,-285,643,2.6438569206842923,46.96734059097978,-44.32348367029549
87083,7,27,-20,71,9.859154929577464,38.028169014084504,-28.16901408450704
87084,28,319,-291,714,3.9215686274509802,44.67787114845939,-40.75630252100841
87085,38,810,-772,1719,2.2105875509016872,47.12041884816754,-44.90983129726585
87086,6,225,-219,468,1.282051282051282,48.07692307692308,-46.794871794871796
87087,22,571,-549,1205,1.8257261410788383,47.38589211618257,-45.56016597510373
87088,27,491,-464,1050,2.571428571428571,46.76190476190476,-44.19047619047619
87089,16,480,-464,1011,1.582591493570722,47.47774480712167,-45.89515331355094
87090,0,0,0,0,0.0,0.0,0.0
87091,0,0,0,0,0.0,0.0,0.0
87092,0,0,0,0,0.0,0.0,0.0
87093,0,0,0,0,0.0,0.0,0.0
87094,0,0,0,0,0.0,0.0,0.0
87095,0,0,0,0,0.0,0.0,0.0
