ed_map_for_viz,Trump,Biden,vote_differences,total_value,trump_pct,biden_pct,vote_counts_pct
77001,27,199,-172,454,5.947136563876652,43.83259911894273,-37.88546255506608
77002,20,202,-182,447,4.47427293064877,45.19015659955257,-40.7158836689038
77003,84,515,-431,1206,6.965174129353234,42.70315091210614,-35.7379767827529
77004,87,408,-321,997,8.72617853560682,40.92276830491474,-32.19658976930792
77005,70,439,-369,1030,6.796116504854369,42.62135922330097,-35.8252427184466
77006,86,491,-405,1157,7.433016421780467,42.43733794295592,-35.004321521175456
77007,63,549,-486,1234,5.105348460291735,44.489465153970826,-39.38411669367909
77008,92,490,-398,1183,7.776838546069316,41.42011834319527,-33.643279797125956
77009,90,480,-390,1150,7.82608695652174,41.73913043478261,-33.91304347826087
77010,77,469,-392,1101,6.993642143505904,42.59763851044505,-35.60399636693915
77011,79,562,-483,1297,6.0909791827293756,43.3307632999229,-37.23978411719352
77012,32,378,-346,823,3.8882138517618468,45.92952612393682,-42.04131227217497
77013,53,356,-303,823,6.439854191980558,43.256379100850545,-36.81652490886999
77014,76,433,-357,1027,7.400194741966894,42.16163583252191,-34.76144109055502
77015,44,228,-184,550,8.0,41.45454545454545,-33.45454545454545
77016,59,374,-315,871,6.77382319173364,42.93915040183697,-36.16532721010333
77017,31,188,-157,441,7.029478458049887,42.63038548752834,-35.600907029478456
77018,66,455,-389,1055,6.2559241706161135,43.127962085308056,-36.872037914691944
77019,79,449,-370,1065,7.417840375586854,42.15962441314554,-34.74178403755869
77020,63,387,-324,904,6.969026548672566,42.809734513274336,-35.84070796460177
77021,93,497,-404,1185,7.848101265822785,41.94092827004219,-34.09282700421941
77022,100,523,-423,1260,7.936507936507936,41.50793650793651,-33.57142857142858
77023,55,464,-409,1045,5.263157894736842,44.40191387559808,-39.13875598086124
77024,46,360,-314,827,5.562273276904474,43.53083434099154,-37.96856106408707
77025,63,571,-508,1274,4.945054945054945,44.81946624803768,-39.874411302982736
77026,41,246,-205,575,7.130434782608695,42.78260869565217,-35.65217391304348
77027,66,575,-509,1293,5.104408352668213,44.470224284609436,-39.36581593194122
77028,81,536,-455,1259,6.433677521842732,42.57347100873709,-36.139793486894355
77029,34,185,-151,446,7.623318385650224,41.47982062780269,-33.856502242152466
77030,26,326,-300,713,3.6465638148667603,45.72230014025245,-42.07573632538569
77031,10,74,-64,170,5.88235294117647,43.529411764705884,-37.64705882352941
77032,62,417,-355,988,6.275303643724696,42.20647773279352,-35.931174089068826
77033,56,349,-293,821,6.82095006090134,42.50913520097443,-35.68818514007309
77034,69,347,-278,843,8.185053380782918,41.16251482799525,-32.977461447212335
77035,55,261,-206,635,8.661417322834646,41.10236220472441,-32.44094488188976
77036,49,500,-451,1107,4.426377597109305,45.16711833785004,-40.74074074074073
77037,55,377,-322,878,6.264236902050115,42.93849658314351,-36.674259681093396
77038,43,279,-236,658,6.5349544072948325,42.401215805471125,-35.86626139817629
77039,89,464,-375,1121,7.939339875111508,41.39161462979482,-33.452274754683316
77040,50,305,-255,714,7.002801120448179,42.71708683473389,-35.71428571428571
77041,79,315,-236,798,9.899749373433583,39.473684210526315,-29.573934837092732
77042,95,404,-309,1005,9.45273631840796,40.19900497512438,-30.746268656716424
77043,62,506,-444,1155,5.367965367965368,43.80952380952381,-38.44155844155844
77044,64,427,-363,995,6.432160804020101,42.91457286432161,-36.48241206030151
77045,42,330,-288,748,5.614973262032086,44.11764705882353,-38.50267379679144
77046,69,357,-288,863,7.995365005793744,41.36732329084589,-33.371958285052145
77047,64,446,-382,1035,6.183574879227053,43.091787439613526,-36.908212560386474
77048,81,398,-317,967,8.376421923474664,41.15822130299897,-32.7817993795243
77049,28,214,-186,490,5.714285714285714,43.673469387755105,-37.95918367346939
77050,57,441,-384,1006,5.666003976143141,43.836978131212724,-38.17097415506959
77051,53,434,-381,977,5.424769703172978,44.42169907881269,-38.996929375639716
77052,6,45,-39,102,5.88235294117647,44.11764705882353,-38.23529411764706
77053,68,562,-494,1275,5.333333333333334,44.07843137254902,-38.745098039215684
77054,74,430,-356,1018,7.269155206286837,42.23968565815324,-34.9705304518664
77055,54,461,-407,1042,5.182341650671785,44.241842610364685,-39.0595009596929
77056,50,486,-436,1081,4.6253469010175765,44.95837187789084,-40.33302497687326
77057,59,457,-398,1046,5.640535372848948,43.69024856596558,-38.04971319311663
77058,55,637,-582,1398,3.934191702432046,45.56509298998569,-41.63090128755365
77059,46,288,-242,676,6.804733727810651,42.60355029585799,-35.79881656804734
77060,50,347,-297,805,6.211180124223603,43.1055900621118,-36.8944099378882
77061,28,156,-128,378,7.4074074074074066,41.269841269841265,-33.86243386243386
77062,54,506,-452,1136,4.753521126760563,44.54225352112676,-39.7887323943662
77063,65,343,-278,823,7.897934386391252,41.67679222357229,-33.77885783718104
77064,10,146,-136,316,3.1645569620253164,46.20253164556962,-43.037974683544306
77065,73,464,-391,1089,6.703397612488522,42.6078971533517,-35.90449954086318
77066,11,43,-32,108,10.185185185185185,39.81481481481482,-29.629629629629633
77067,45,319,-274,738,6.097560975609756,43.22493224932249,-37.12737127371274
77068,53,474,-421,1070,4.953271028037383,44.299065420560744,-39.34579439252336
77070,0,0,0,0,0.0,0.0,0.0
77071,103,551,-448,1320,7.803030303030304,41.74242424242424,-33.93939393939394
77072,44,425,-381,955,4.607329842931937,44.50261780104712,-39.89528795811518
77074,79,513,-434,1192,6.62751677852349,43.03691275167785,-36.40939597315436
77075,59,317,-258,755,7.81456953642384,41.98675496688742,-34.17218543046358
77076,71,420,-349,988,7.186234817813765,42.51012145748988,-35.32388663967612
77077,29,230,-201,525,5.523809523809524,43.80952380952381,-38.285714285714285
77078,86,482,-396,1153,7.458803122289679,41.803989592367735,-34.345186470078055
77079,50,289,-239,683,7.320644216691069,42.313323572474374,-34.9926793557833
77080,43,216,-173,518,8.301158301158301,41.6988416988417,-33.397683397683394
77081,53,356,-303,823,6.439854191980558,43.256379100850545,-36.81652490886999
77082,22,197,-175,443,4.966139954853273,44.46952595936794,-39.50338600451467
78001,46,405,-359,910,5.054945054945055,44.505494505494504,-39.450549450549445
78002,30,279,-249,628,4.777070063694268,44.42675159235669,-39.64968152866242
78003,87,434,-347,1057,8.230842005676443,41.05960264900662,-32.82876064333018
78004,22,240,-218,531,4.143126177024483,45.19774011299435,-41.05461393596987
78005,75,366,-291,890,8.426966292134832,41.12359550561798,-32.69662921348315
78006,99,605,-506,1432,6.91340782122905,42.2486033519553,-35.33519553072625
78007,32,137,-105,348,9.195402298850574,39.36781609195402,-30.172413793103445
78008,97,514,-417,1243,7.803700724054706,41.3515687851971,-33.547868061142395
78009,43,320,-277,736,5.842391304347826,43.47826086956522,-37.63586956521739
78010,61,435,-374,1012,6.027667984189724,42.984189723320156,-36.95652173913043
78011,48,382,-334,897,5.351170568561873,42.58639910813824,-37.23522853957637
78012,66,337,-271,820,8.048780487804878,41.09756097560975,-33.048780487804876
78013,91,626,-535,1479,6.152805949966194,42.32589587559162,-36.173089925625426
78014,87,551,-464,1299,6.697459584295612,42.41724403387221,-35.71978444957659
78015,82,368,-286,909,9.02090209020902,40.484048404840486,-31.463146314631466
78016,81,441,-360,1057,7.663197729422895,41.72185430463576,-34.058656575212865
78017,56,183,-127,480,11.666666666666666,38.125,-26.458333333333336
78018,100,480,-380,1164,8.59106529209622,41.23711340206185,-32.64604810996563
78019,111,378,-267,1004,11.055776892430279,37.64940239043825,-26.593625498007967
78020,57,482,-425,1092,5.21978021978022,44.13919413919414,-38.91941391941392
78021,83,402,-319,976,8.504098360655737,41.18852459016394,-32.6844262295082
78022,85,419,-334,1032,8.236434108527131,40.60077519379845,-32.36434108527132
78023,69,364,-295,881,7.832009080590238,41.316685584563,-33.48467650397276
78024,68,363,-295,865,7.8612716763005785,41.96531791907515,-34.10404624277457
78025,127,543,-416,1356,9.365781710914455,40.04424778761062,-30.678466076696168
78026,84,606,-522,1414,5.9405940594059405,42.857142857142854,-36.916548797736915
78027,84,586,-502,1365,6.153846153846154,42.93040293040293,-36.776556776556774
78028,60,367,-307,867,6.920415224913495,42.32987312572088,-35.40945790080738
78029,94,492,-398,1183,7.945900253592561,41.58918005071851,-33.64327979712595
78030,73,326,-253,804,9.07960199004975,40.547263681592035,-31.467661691542283
78031,94,468,-374,1131,8.311229000884174,41.37931034482759,-33.06808134394341
78032,85,401,-316,986,8.620689655172415,40.66937119675456,-32.04868154158215
78033,129,618,-489,1518,8.49802371541502,40.71146245059288,-32.21343873517786
78034,80,399,-319,966,8.281573498964804,41.30434782608695,-33.02277432712215
78035,35,181,-146,445,7.865168539325842,40.67415730337079,-32.80898876404495
78036,78,490,-412,1153,6.764960971379011,42.497831743278404,-35.73287077189939
78037,13,51,-38,128,10.15625,39.84375,-29.6875
78038,106,515,-409,1261,8.406026962727994,40.840602696272796,-32.434575733544804
78039,32,149,-117,370,8.64864864864865,40.27027027027027,-31.621621621621617
78040,126,546,-420,1350,9.333333333333334,40.44444444444444,-31.111111111111107
78041,135,549,-414,1387,9.733237202595529,39.58183129055515,-29.848594087959622
78042,0,2,-2,4,0.0,50.0,-50.0
78043,41,184,-143,453,9.050772626931568,40.618101545253865,-31.567328918322296
78044,87,464,-377,1120,7.767857142857143,41.42857142857143,-33.660714285714285
78045,78,310,-232,782,9.974424552429667,39.64194373401534,-29.667519181585675
78046,52,288,-236,689,7.547169811320755,41.79970972423803,-34.25253991291727
78047,103,449,-346,1111,9.27092709270927,40.41404140414041,-31.14311431143114
78048,81,723,-642,1622,4.99383477188656,44.574599260172626,-39.580764488286064
78049,79,534,-455,1241,6.365834004834811,43.02981466559226,-36.66398066075745
78050,95,447,-352,1093,8.69167429094236,40.896614821591946,-32.20494053064959
78051,80,346,-266,858,9.324009324009324,40.32634032634033,-31.002331002331005
78052,54,358,-304,832,6.490384615384616,43.02884615384615,-36.53846153846154
78053,68,401,-333,946,7.188160676532769,42.38900634249472,-35.20084566596195
78054,53,311,-258,741,7.152496626180836,41.97031039136302,-34.81781376518219
78055,0,0,0,0,0.0,0.0,0.0
78059,97,360,-263,917,10.577971646673937,39.25845147219193,-28.680479825517992
78060,100,452,-352,1117,8.952551477170994,40.46553267681289,-31.5129811996419
78061,58,281,-223,683,8.49194729136164,41.142020497803806,-32.650073206442165
78062,68,308,-240,766,8.87728459530026,40.2088772845953,-31.331592689295043
78063,34,185,-151,443,7.674943566591422,41.760722347629795,-34.08577878103837
78064,43,300,-257,707,6.082036775106082,42.432814710042436,-36.35077793493635
78065,137,597,-460,1487,9.213180901143241,40.147948890383326,-30.934767989240086
78066,69,224,-155,592,11.655405405405405,37.83783783783784,-26.182432432432435
78067,75,380,-305,930,8.064516129032258,40.86021505376344,-32.795698924731184
78068,27,129,-102,319,8.463949843260188,40.43887147335423,-31.974921630094045
78069,54,458,-404,1032,5.232558139534884,44.37984496124031,-39.14728682170542
78070,62,305,-243,746,8.310991957104557,40.88471849865952,-32.57372654155496
78071,65,399,-334,937,6.937033084311634,42.58271077908218,-35.64567769477054
78072,56,257,-201,633,8.846761453396525,40.60031595576619,-31.753554502369667
78073,68,277,-209,696,9.770114942528735,39.798850574712645,-30.02873563218391
79001,43,301,-258,690,6.231884057971015,43.6231884057971,-37.391304347826086
79002,77,408,-331,981,7.8491335372069315,41.59021406727829,-33.74108053007136
79003,51,464,-413,1040,4.903846153846154,44.61538461538462,-39.71153846153847
79004,57,441,-384,1003,5.682951146560319,43.96809571286141,-38.28514456630109
79005,31,393,-362,853,3.6342321219226257,46.07268464243845,-42.438452520515824
79006,58,329,-271,778,7.455012853470437,42.28791773778921,-34.83290488431877
79007,61,407,-346,941,6.482465462274177,43.251859723698196,-36.76939426142402
79008,56,402,-346,925,6.054054054054054,43.45945945945946,-37.4054054054054
79009,20,204,-184,451,4.434589800443459,45.23281596452328,-40.79822616407982
79010,57,326,-269,776,7.345360824742269,42.01030927835052,-34.66494845360825
79011,34,265,-231,602,5.647840531561462,44.01993355481728,-38.372093023255815
79012,21,109,-88,262,8.015267175572518,41.603053435114504,-33.587786259541986
79013,90,442,-352,1074,8.379888268156424,41.154562383612664,-32.774674115456236
79014,23,188,-165,436,5.275229357798166,43.11926605504588,-37.84403669724771
79015,42,390,-348,869,4.833141542002301,44.87917146144994,-40.04602991944764
79016,61,396,-335,919,6.637649619151251,43.09031556039173,-36.45266594124048
79017,61,428,-367,997,6.118355065195587,42.92878635907723,-36.81043129388164
79018,31,407,-376,893,3.4714445688689812,45.576707726763715,-42.10526315789473
79019,37,299,-262,678,5.457227138643068,44.100294985250734,-38.643067846607664
79020,45,373,-328,845,5.325443786982249,44.142011834319526,-38.81656804733728
79021,33,313,-280,694,4.755043227665706,45.10086455331412,-40.34582132564841
79022,27,280,-253,617,4.376012965964344,45.38087520259319,-41.004862236628846
79023,46,327,-281,763,6.028833551769332,42.857142857142854,-36.82830930537352
79024,57,409,-352,940,6.0638297872340425,43.51063829787234,-37.4468085106383
79025,56,523,-467,1168,4.794520547945205,44.77739726027397,-39.98287671232877
79026,97,551,-454,1309,7.4102368220015284,42.093200916730325,-34.682964094728796
79027,67,517,-450,1186,5.649241146711636,43.59190556492412,-37.94266441821248
79028,82,597,-515,1363,6.016140865737344,43.800440205429204,-37.78429933969186
79030,54,348,-294,814,6.6339066339066335,42.75184275184275,-36.11793611793612
79031,39,404,-365,889,4.386951631046119,45.44431946006749,-41.05736782902137
79032,47,434,-387,972,4.8353909465020575,44.650205761316876,-39.81481481481482
79033,53,458,-405,1035,5.120772946859904,44.251207729468604,-39.1304347826087
79034,50,397,-347,902,5.543237250554324,44.01330376940133,-38.470066518847005
79035,51,454,-403,1015,5.024630541871921,44.72906403940887,-39.70443349753695
79036,52,474,-422,1067,4.873477038425492,44.42361761949391,-39.55014058106842
79037,29,396,-367,863,3.360370799536501,45.886442641946694,-42.52607184241019
79038,44,453,-409,1000,4.3999999999999995,45.300000000000004,-40.900000000000006
79039,64,514,-450,1161,5.512489233419466,44.27217915590009,-38.759689922480625
79040,77,551,-474,1268,6.072555205047318,43.45425867507887,-37.38170347003155
79041,38,552,-514,1182,3.2148900169204735,46.7005076142132,-43.48561759729273
79042,63,485,-422,1104,5.706521739130435,43.93115942028986,-38.22463768115942
79043,58,456,-398,1034,5.609284332688588,44.10058027079304,-38.49129593810445
79044,74,487,-413,1129,6.554472984942426,43.13551815766164,-36.581045172719215
79045,53,470,-417,1058,5.00945179584121,44.423440453686204,-39.413988657844996
79046,35,468,-433,1022,3.4246575342465753,45.79256360078278,-42.3679060665362
79047,62,396,-334,935,6.631016042780749,42.35294117647059,-35.72192513368984
79048,61,424,-363,982,6.211812627291242,43.17718940936864,-36.96537678207739
79049,41,426,-385,949,4.3203371970495255,44.889357218124346,-40.56902002107482
79050,56,394,-338,906,6.181015452538632,43.4878587196468,-37.30684326710817
79051,28,429,-401,926,3.023758099352052,46.32829373650108,-43.30453563714903
79052,51,419,-368,950,5.36842105263158,44.10526315789474,-38.73684210526316
79053,70,625,-555,1402,4.9928673323823105,44.57917261055635,-39.58630527817404
79054,58,390,-332,912,6.359649122807018,42.76315789473684,-36.40350877192982
79055,18,143,-125,327,5.5045871559633035,43.730886850152906,-38.226299694189606
79056,76,447,-371,1058,7.183364839319471,42.24952741020794,-35.066162570888466
79057,68,591,-523,1324,5.13595166163142,44.637462235649544,-39.50151057401813
79058,73,474,-401,1101,6.630336058128973,43.05177111716621,-36.421435059037236
79059,55,442,-387,1003,5.483549351944168,44.06779661016949,-38.58424725822532
79060,24,214,-190,482,4.979253112033195,44.398340248962654,-39.41908713692946
79061,63,438,-375,1014,6.21301775147929,43.19526627218935,-36.98224852071006
79062,82,559,-477,1297,6.322282189668465,43.09946029298381,-36.77717810331534
79063,44,391,-347,879,5.005688282138794,44.48236632536974,-39.47667804323095
79064,43,366,-323,822,5.231143552311435,44.52554744525548,-39.29440389294404
79065,47,341,-294,782,6.010230179028133,43.60613810741688,-37.59590792838875
79066,50,350,-300,819,6.105006105006105,42.73504273504273,-36.63003663003663
79067,44,233,-189,556,7.913669064748201,41.906474820143885,-33.992805755395686
79068,47,600,-553,1311,3.585049580472922,45.766590389016024,-42.181540808543105
79069,61,625,-564,1385,4.404332129963899,45.12635379061371,-40.722021660649816
79070,26,280,-254,623,4.173354735152488,44.9438202247191,-40.77046548956661
79071,22,210,-188,467,4.710920770877944,44.96788008565311,-40.25695931477516
79072,64,517,-453,1174,5.45144804088586,44.03747870528109,-38.58603066439523
79073,67,348,-281,835,8.023952095808383,41.67664670658683,-33.65269461077845
79074,15,77,-62,190,7.894736842105263,40.526315789473685,-32.631578947368425
79075,69,492,-423,1130,6.106194690265487,43.53982300884956,-37.43362831858407
79076,67,441,-374,1029,6.511175898931001,42.857142857142854,-36.345966958211854
79077,15,154,-139,343,4.373177842565598,44.89795918367347,-40.524781341107875
79078,9,201,-192,429,2.097902097902098,46.85314685314685,-44.75524475524475
79079,25,203,-178,458,5.458515283842795,44.32314410480349,-38.8646288209607
79080,0,0,0,0,0.0,0.0,0.0
79082,22,197,-175,444,4.954954954954955,44.36936936936937,-39.414414414414416
79083,60,489,-429,1106,5.424954792043399,44.21338155515371,-38.78842676311031
79084,62,472,-410,1083,5.724838411819022,43.58264081255771,-37.85780240073869
79085,33,303,-270,683,4.831625183016105,44.36310395314788,-39.53147877013177
79086,69,453,-384,1047,6.59025787965616,43.26647564469914,-36.676217765042985
79087,30,270,-240,607,4.942339373970346,44.481054365733115,-39.53871499176277
79088,5,52,-47,114,4.385964912280701,45.614035087719294,-41.228070175438596
79089,60,631,-571,1400,4.285714285714286,45.07142857142858,-40.78571428571429
79090,41,592,-551,1286,3.188180404354588,46.034214618973564,-42.846034214618975
80001,75,265,-190,693,10.822510822510822,38.23953823953824,-27.41702741702742
80002,40,280,-240,651,6.1443932411674345,43.01075268817204,-36.866359447004605
80003,372,248,124,1250,29.759999999999998,19.84,9.919999999999998
80004,117,147,-30,540,21.666666666666668,27.22222222222222,-5.555555555555554
80005,74,112,-38,376,19.680851063829788,29.78723404255319,-10.106382978723403
80006,112,155,-43,546,20.51282051282051,28.388278388278387,-7.875457875457876
80007,112,167,-55,578,19.377162629757784,28.892733564013838,-9.515570934256054
80008,84,152,-68,479,17.536534446764094,31.732776617954073,-14.19624217118998
80009,60,227,-167,582,10.309278350515463,39.00343642611684,-28.69415807560138
80010,139,356,-217,1003,13.858424725822532,35.49351944167498,-21.635094715852446
80011,43,85,-42,258,16.666666666666664,32.945736434108525,-16.27906976744186
80012,71,200,-129,553,12.839059674502712,36.166365280289334,-23.32730560578662
80013,82,334,-252,839,9.773539928486292,39.8092967818832,-30.035756853396904
80014,49,405,-356,918,5.337690631808279,44.11764705882353,-38.77995642701525
80015,42,257,-215,604,6.95364238410596,42.549668874172184,-35.59602649006622
80016,79,401,-322,970,8.144329896907216,41.340206185567006,-33.19587628865979
80017,70,438,-368,1022,6.8493150684931505,42.857142857142854,-36.007827788649706
80018,118,153,-35,555,21.26126126126126,27.56756756756757,-6.306306306306308
80019,111,106,5,442,25.1131221719457,23.981900452488688,1.131221719457013
80020,107,385,-278,1000,10.7,38.5,-27.8
80021,96,471,-375,1143,8.398950131233596,41.20734908136483,-32.808398950131235
80022,100,460,-360,1160,8.620689655172415,39.6551724137931,-31.03448275862069
80023,96,454,-358,1113,8.62533692722372,40.79065588499551,-32.16531895777179
80024,67,305,-238,763,8.781127129750983,39.973787680209696,-31.19266055045871
80025,81,354,-273,885,9.152542372881356,40.0,-30.847457627118644
80026,117,328,-211,895,13.072625698324023,36.64804469273743,-23.575418994413404
80027,124,237,-113,733,16.916780354706685,32.33287858117326,-15.416098226466577
80028,172,320,-148,992,17.338709677419356,32.25806451612903,-14.919354838709676
80029,85,99,-14,370,22.972972972972975,26.756756756756754,-3.783783783783779
80030,286,311,-25,1215,23.53909465020576,25.596707818930042,-2.0576131687242807
80031,284,422,-138,1434,19.804741980474198,29.428172942817294,-9.623430962343097
80032,186,216,-30,810,22.962962962962962,26.666666666666668,-3.703703703703706
80033,164,187,-23,706,23.229461756373937,26.487252124645895,-3.2577903682719587
80034,136,243,-107,767,17.731421121251632,31.681877444589308,-13.950456323337676
80035,163,196,-33,724,22.513812154696133,27.071823204419886,-4.558011049723753
80036,144,420,-276,1138,12.65377855887522,36.90685413005272,-24.2530755711775
80037,116,190,-74,618,18.77022653721683,30.74433656957929,-11.97411003236246
80038,89,293,-204,781,11.395646606914212,37.516005121638926,-26.120358514724714
80039,173,452,-279,1266,13.665086887835704,35.70300157977883,-22.037914691943122
80040,40,235,-195,557,7.1813285457809695,42.190305206463194,-35.00897666068222
80041,89,538,-449,1271,7.002360346184107,42.32887490165224,-35.32651455546814
80042,48,338,-290,780,6.153846153846154,43.333333333333336,-37.17948717948718
80043,108,347,-239,922,11.713665943600867,37.635574837310195,-25.92190889370933
80044,123,267,-144,792,15.530303030303031,33.71212121212121,-18.18181818181818
80045,137,398,-261,1088,12.591911764705882,36.580882352941174,-23.98897058823529
80046,33,186,-153,442,7.46606334841629,42.081447963800905,-34.61538461538461
80047,69,329,-260,809,8.529048207663783,40.66749072929542,-32.13844252163164
80048,90,520,-430,1238,7.269789983844912,42.003231017770595,-34.733441033925686
80049,1,24,-23,50,2.0,48.0,-46.0
80050,33,319,-286,712,4.634831460674158,44.80337078651686,-40.1685393258427
80051,95,282,-187,764,12.43455497382199,36.910994764397905,-24.476439790575917
80052,62,480,-418,1099,5.641492265696088,43.67606915377616,-38.034576888080075
80053,58,351,-293,822,7.0559610705596105,42.700729927007295,-35.64476885644768
80054,28,141,-113,340,8.235294117647058,41.47058823529412,-33.235294117647065
80055,71,549,-478,1254,5.6618819776714515,43.7799043062201,-38.11802232854865
80056,36,539,-503,1159,3.106125970664366,46.50560828300259,-43.39948231233822
80057,39,148,-109,376,10.372340425531915,39.361702127659576,-28.98936170212766
80058,129,544,-415,1359,9.492273730684326,40.02943340691685,-30.537159676232527
80059,13,111,-98,248,5.241935483870968,44.75806451612903,-39.516129032258064
80060,58,534,-476,1196,4.849498327759197,44.64882943143812,-39.799331103678924
80061,7,109,-102,234,2.9914529914529915,46.58119658119658,-43.58974358974359
80062,62,397,-335,930,6.666666666666667,42.68817204301075,-36.02150537634409
80063,67,626,-559,1405,4.7686832740213525,44.555160142348754,-39.7864768683274
80064,39,381,-342,846,4.609929078014184,45.0354609929078,-40.42553191489362
80065,39,600,-561,1287,3.0303030303030303,46.620046620046615,-43.589743589743584
80066,112,215,-103,658,17.02127659574468,32.67477203647417,-15.653495440729486
80067,112,398,-286,1024,10.9375,38.8671875,-27.9296875
80068,124,329,-205,911,13.611416026344674,36.11416026344676,-22.50274423710209
80069,33,171,-138,410,8.048780487804878,41.70731707317073,-33.65853658536585
80070,115,434,-319,1105,10.407239819004525,39.276018099547514,-28.86877828054299
80071,60,371,-311,870,6.896551724137931,42.64367816091954,-35.74712643678161
80073,37,283,-246,649,5.701078582434515,43.6055469953775,-37.90446841294299
80074,39,436,-397,964,4.045643153526971,45.22821576763486,-41.18257261410788
80075,2,10,-8,24,8.333333333333332,41.66666666666667,-33.33333333333334
80076,101,273,-172,760,13.289473684210526,35.921052631578945,-22.631578947368418
80077,87,380,-293,952,9.138655462184873,39.91596638655462,-30.77731092436975
80078,98,529,-431,1277,7.674236491777604,41.42521534847298,-33.750978856695376
80079,82,490,-408,1158,7.081174438687392,42.31433506044905,-35.233160621761655
80080,126,645,-519,1562,8.066581306017925,41.293213828425095,-33.22663252240717
80081,104,495,-391,1217,8.545603944124897,40.673788003286774,-32.128184059161875
80082,54,252,-198,616,8.766233766233766,40.909090909090914,-32.142857142857146
80083,115,547,-432,1334,8.620689655172415,41.00449775112443,-32.38380809595202
80084,99,423,-324,1058,9.357277882797732,39.981096408317576,-30.623818525519845
80085,68,451,-383,1052,6.4638783269961975,42.870722433460074,-36.40684410646388
80086,70,365,-295,882,7.936507936507936,41.383219954648524,-33.44671201814059
80087,30,243,-213,553,5.424954792043399,43.942133815551536,-38.517179023508135
80088,0,0,0,0,0.0,0.0,0.0
80089,0,0,0,0,0.0,0.0,0.0
80093,76,316,-240,794,9.571788413098236,39.79848866498741,-30.226700251889174
80094,100,530,-430,1284,7.78816199376947,41.27725856697819,-33.48909657320872
80095,86,458,-372,1097,7.839562443026436,41.750227894257065,-33.91066545123063
81001,55,353,-298,829,6.634499396863691,42.58142340168878,-35.94692400482509
81002,126,442,-316,1142,11.033274956217163,38.704028021015766,-27.670753064798603
81003,80,386,-306,940,8.51063829787234,41.06382978723404,-32.5531914893617
81004,78,340,-262,850,9.176470588235293,40.0,-30.823529411764707
81005,107,478,-371,1184,9.037162162162163,40.37162162162162,-31.33445945945946
81006,124,526,-402,1318,9.408194233687405,39.90895295902883,-30.500758725341427
81007,140,461,-321,1219,11.484823625922887,37.817883511074655,-26.33305988515177
81008,48,257,-209,621,7.729468599033816,41.38486312399356,-33.655394524959746
81009,49,277,-228,668,7.335329341317365,41.467065868263475,-34.13173652694611
81010,23,181,-158,416,5.528846153846153,43.50961538461539,-37.98076923076923
81011,13,122,-109,274,4.744525547445255,44.52554744525548,-39.78102189781022
81012,111,610,-499,1460,7.602739726027398,41.78082191780822,-34.17808219178082
81013,47,266,-219,642,7.320872274143301,41.43302180685358,-34.112149532710276
81014,57,353,-296,844,6.753554502369669,41.824644549763036,-35.07109004739337
81015,114,510,-396,1270,8.976377952755906,40.15748031496063,-31.181102362204726
81017,59,574,-515,1276,4.623824451410658,44.98432601880878,-40.360501567398124
81018,52,415,-363,943,5.514316012725344,44.008483563096505,-38.49416755037116
81019,88,574,-486,1342,6.557377049180328,42.77198211624441,-36.214605067064085
81020,65,604,-539,1344,4.836309523809524,44.94047619047619,-40.104166666666664
81021,58,583,-525,1292,4.489164086687306,45.12383900928793,-40.634674922600624
81022,45,468,-423,1034,4.352030947775629,45.26112185686654,-40.90909090909091
81023,84,625,-541,1461,5.749486652977413,42.77891854893908,-37.02943189596167
81024,43,393,-350,889,4.83689538807649,44.20697412823397,-39.37007874015748
81025,154,216,-62,755,20.397350993377483,28.60927152317881,-8.211920529801326
81026,86,221,-135,636,13.522012578616351,34.74842767295597,-21.226415094339618
81027,188,222,-34,837,22.461170848267624,26.523297491039425,-4.062126642771801
81028,169,244,-75,852,19.835680751173708,28.638497652582164,-8.802816901408455
81029,147,165,-18,635,23.1496062992126,25.984251968503933,-2.8346456692913335
81030,240,255,-15,1001,23.976023976023978,25.47452547452547,-1.4985014985014935
81031,187,175,12,743,25.168236877523555,23.553162853297444,1.6150740242261108
81032,157,209,-52,747,21.01740294511379,27.978580990629183,-6.961178045515393
81033,105,400,-295,1032,10.174418604651162,38.759689922480625,-28.585271317829463
81034,122,475,-353,1226,9.9510603588907,38.743882544861336,-28.792822185970635
81035,169,575,-406,1515,11.155115511551156,37.95379537953795,-26.798679867986795
81036,102,448,-346,1112,9.172661870503598,40.28776978417266,-31.115107913669064
81037,130,543,-413,1377,9.44081336238199,39.433551198257085,-29.992737835875097
81038,111,565,-454,1361,8.155767817781042,41.51359294636297,-33.35782512858193
81039,86,282,-196,738,11.653116531165312,38.21138211382114,-26.558265582655828
81040,117,533,-416,1314,8.904109589041095,40.56316590563166,-31.65905631659056
81041,184,564,-380,1533,12.002609262883235,36.79060665362035,-24.787997390737118
81042,50,156,-106,416,12.01923076923077,37.5,-25.48076923076923
81043,93,307,-214,820,11.341463414634147,37.4390243902439,-26.097560975609753
81044,103,260,-157,738,13.956639566395665,35.230352303523034,-21.27371273712737
81045,31,123,-92,315,9.841269841269842,39.04761904761905,-29.20634920634921
81046,32,205,-173,475,6.7368421052631575,43.15789473684211,-36.42105263157895
81047,41,119,-78,340,12.058823529411764,35.0,-22.941176470588236
81048,63,436,-373,1036,6.081081081081082,42.084942084942085,-36.003861003861005
81049,96,303,-207,827,11.608222490931077,36.638452237001204,-25.030229746070127
81050,76,421,-345,1054,7.2106261859582546,39.94307400379506,-32.73244781783681
81051,72,284,-212,815,8.83435582822086,34.84662576687116,-26.012269938650306
81052,38,113,-75,384,9.895833333333332,29.427083333333332,-19.53125
81053,66,153,-87,481,13.721413721413722,31.80873180873181,-18.08731808731809
81054,123,535,-412,1387,8.868060562364816,38.57245854361932,-29.704397981254502
81055,161,486,-325,1390,11.58273381294964,34.96402877697842,-23.381294964028775
81056,165,462,-297,1299,12.702078521939955,35.56581986143187,-22.863741339491916
81057,97,233,-136,738,13.143631436314362,31.571815718157183,-18.42818428184282
81058,111,356,-245,1001,11.08891108891109,35.56443556443556,-24.475524475524473
81059,139,273,-134,874,15.903890160183066,31.23569794050343,-15.331807780320366
81060,158,390,-232,1121,14.094558429973238,34.79036574487065,-20.695807314897408
81061,79,209,-130,599,13.18864774624374,34.891485809682806,-21.702838063439067
81062,73,428,-355,1032,7.073643410852713,41.47286821705426,-34.39922480620155
81063,142,358,-216,1032,13.75968992248062,34.689922480620154,-20.930232558139537
81064,119,673,-554,1691,7.03725606150207,39.79893554109994,-32.761679479597866
81065,155,491,-336,1321,11.733535200605601,37.168811506434515,-25.435276305828914
81066,93,246,-153,690,13.478260869565217,35.65217391304348,-22.173913043478258
81067,74,299,-225,784,9.438775510204081,38.13775510204081,-28.698979591836732
81068,122,400,-278,1135,10.748898678414097,35.24229074889868,-24.493392070484585
81069,179,483,-304,1436,12.465181058495823,33.635097493036206,-21.169916434540383
81070,24,114,-90,336,7.142857142857142,33.92857142857143,-26.78571428571429
81071,93,321,-228,897,10.367892976588628,35.785953177257525,-25.418060200668897
81072,180,566,-386,1518,11.857707509881422,37.285902503293805,-25.428194993412383
81073,168,575,-407,1595,10.532915360501567,36.05015673981191,-25.51724137931034
81074,100,408,-308,1071,9.337068160597573,38.095238095238095,-28.75816993464052
81075,102,505,-403,1279,7.97498045347928,39.48397185301016,-31.50899139953088
81076,119,363,-244,1039,11.453320500481231,34.93743984600577,-23.48411934552454
81077,90,436,-346,1071,8.403361344537815,40.70961718020541,-32.3062558356676
81078,147,630,-483,1633,9.001837109614206,38.5793018983466,-29.577464788732392
81079,150,455,-305,1275,11.76470588235294,35.68627450980392,-23.92156862745098
81080,72,518,-446,1229,5.858421480878763,42.148087876322215,-36.289666395443454
81081,62,399,-337,967,6.41158221302999,41.26163391933816,-34.85005170630817
81082,82,360,-278,929,8.826695371367062,38.751345532831,-29.92465016146394
81083,86,328,-242,855,10.058479532163743,38.3625730994152,-28.304093567251456
81084,128,610,-482,1527,8.382449246889326,39.94760969220694,-31.565160445317613
81085,65,243,-178,640,10.15625,37.96875,-27.8125
81086,129,389,-260,1075,12.0,36.18604651162791,-24.186046511627907
81087,90,382,-292,974,9.240246406570842,39.21971252566735,-29.979466119096507
81088,132,330,-198,933,14.14790996784566,35.36977491961415,-21.22186495176849
81089,61,348,-287,836,7.29665071770335,41.62679425837321,-34.33014354066986
81090,79,376,-297,938,8.422174840085288,40.085287846481876,-31.663113006396586
81091,42,231,-189,562,7.473309608540925,41.10320284697509,-33.629893238434164
81092,52,293,-241,698,7.4498567335243555,41.977077363896846,-34.52722063037249
81093,76,446,-370,1063,7.149576669802446,41.95672624647225,-34.8071495766698
81094,44,409,-365,914,4.814004376367615,44.74835886214442,-39.93435448577681
81095,82,194,-112,568,14.43661971830986,34.154929577464785,-19.718309859154925
81096,73,323,-250,797,9.159347553324968,40.52697616060226,-31.36762860727729
81097,49,451,-402,1019,4.808635917566241,44.25907752698725,-39.450441609421006
81098,67,426,-359,1017,6.588003933136677,41.88790560471977,-35.29990167158309
81099,111,490,-379,1277,8.692247454972591,38.37118245888802,-29.67893500391543
81100,72,349,-277,847,8.500590318772137,41.20425029515938,-32.70365997638724
81102,0,0,0,0,0.0,0.0,0.0
81104,0,0,0,0,0.0,0.0,0.0
81105,0,0,0,0,0.0,0.0,0.0
81106,0,0,0,0,0.0,0.0,0.0
81107,26,215,-189,487,5.338809034907597,44.14784394250513,-38.809034907597535
82001,422,207,215,1310,32.213740458015266,15.801526717557252,16.412213740458014
82002,321,293,28,1252,25.63897763578275,23.40255591054313,2.236421725239623
82003,275,131,144,823,33.41433778857837,15.91737545565006,17.496962332928312
82004,351,184,167,1147,30.601569311246728,16.041848299912818,14.55972101133391
82005,331,362,-31,1456,22.733516483516482,24.862637362637365,-2.129120879120883
82006,252,390,-138,1343,18.763961280714817,29.03946388682055,-10.275502606105732
82007,243,325,-82,1179,20.610687022900763,27.565733672603905,-6.955046649703142
82008,194,521,-327,1445,13.42560553633218,36.055363321799305,-22.629757785467127
82009,216,421,-205,1292,16.718266253869967,32.585139318885446,-15.86687306501548
82010,228,487,-259,1442,15.811373092926493,33.77253814147018,-17.961165048543684
82011,206,405,-199,1240,16.612903225806452,32.66129032258064,-16.04838709677419
82012,26,276,-250,642,4.049844236760125,42.99065420560748,-38.940809968847354
82013,44,360,-316,818,5.378973105134474,44.00977995110024,-38.630806845965765
82014,22,154,-132,378,5.82010582010582,40.74074074074074,-34.920634920634924
82015,69,436,-367,1025,6.731707317073171,42.53658536585366,-35.80487804878049
82016,208,403,-195,1254,16.586921850079744,32.1371610845295,-15.550239234449759
82017,217,324,-107,1155,18.787878787878785,28.05194805194805,-9.264069264069263
82018,104,259,-155,740,14.054054054054054,35.0,-20.945945945945944
82019,156,210,-54,738,21.138211382113823,28.455284552845526,-7.317073170731703
82020,215,222,-7,912,23.574561403508774,24.342105263157894,-0.7675438596491198
82021,116,222,-106,703,16.500711237553343,31.57894736842105,-15.078236130867708
82022,185,365,-180,1165,15.879828326180256,31.330472103004293,-15.450643776824037
82023,86,419,-333,1020,8.431372549019608,41.07843137254902,-32.64705882352941
82024,185,449,-264,1296,14.274691358024691,34.64506172839506,-20.370370370370374
82025,212,392,-180,1228,17.263843648208468,31.921824104234524,-14.657980456026056
82027,78,389,-311,950,8.210526315789474,40.94736842105263,-32.73684210526316
82028,105,511,-406,1258,8.34658187599364,40.62003179650239,-32.273449920508746
82029,44,154,-110,398,11.055276381909549,38.69346733668342,-27.63819095477387
82030,102,499,-397,1219,8.367514356029531,40.935192780968,-32.56767842493847
82031,104,514,-410,1252,8.30670926517572,41.054313099041536,-32.74760383386582
82032,230,425,-195,1337,17.202692595362752,31.787584143605084,-14.584891548242332
82033,244,312,-68,1197,20.384294068504595,26.065162907268167,-5.680868838763573
82034,169,271,-102,900,18.777777777777775,30.11111111111111,-11.333333333333336
82035,271,487,-216,1558,17.394094993581515,31.258023106546855,-13.86392811296534
82036,212,453,-241,1347,15.738678544914626,33.630289532293986,-17.89161098737936
82037,149,410,-261,1129,13.197519929140833,36.315323294951284,-23.117803365810452
82038,172,555,-383,1465,11.74061433447099,37.883959044368595,-26.143344709897605
82039,196,381,-185,1163,16.85296646603611,32.76010318142734,-15.907136715391228
82040,248,259,-11,1023,24.242424242424242,25.317693059628542,-1.0752688172043001
82041,329,277,52,1237,26.596604688763136,22.392886014551333,4.203718674211803
82042,169,153,16,697,24.2467718794835,21.951219512195124,2.2955523672883764
82043,292,222,70,1039,28.103946102021176,21.36669874879692,6.737247353224255
82044,350,273,77,1256,27.86624203821656,21.73566878980892,6.130573248407639
82045,284,194,90,965,29.430051813471504,20.10362694300518,9.326424870466322
82046,338,228,110,1147,29.46817785527463,19.87794245858762,9.59023539668701
82047,328,209,119,1083,30.28624192059095,19.298245614035086,10.987996306555864
82048,338,232,106,1155,29.264069264069263,20.086580086580085,9.177489177489178
82049,440,268,172,1443,30.49203049203049,18.572418572418574,11.919611919611917
82050,124,290,-166,862,14.385150812064964,33.64269141531322,-19.25754060324826
82051,191,435,-244,1331,14.350112697220135,32.682193839218634,-18.3320811419985
82052,249,464,-215,1456,17.10164835164835,31.868131868131865,-14.766483516483515
82053,128,325,-197,946,13.530655391120508,34.35517970401691,-20.824524312896404
82054,2,46,-44,105,1.9047619047619049,43.80952380952381,-41.904761904761905
82055,170,245,-75,853,19.929660023446658,28.722157092614303,-8.792497069167645
82056,167,330,-163,1009,16.55104063429138,32.70564915758176,-16.15460852329038
82057,198,342,-144,1104,17.934782608695652,30.978260869565215,-13.043478260869563
82058,235,292,-57,1067,22.02436738519213,27.366447985004687,-5.342080599812558
82059,11,48,-37,135,8.148148148148149,35.55555555555556,-27.40740740740741
82060,247,322,-75,1148,21.515679442508713,28.04878048780488,-6.533101045296167
82061,262,381,-119,1310,20.0,29.083969465648856,-9.083969465648856
82062,246,320,-74,1160,21.20689655172414,27.586206896551722,-6.379310344827584
82063,215,268,-53,984,21.84959349593496,27.235772357723576,-5.386178861788615
82064,123,507,-384,1266,9.715639810426541,40.047393364928915,-30.331753554502374
82065,40,388,-348,875,4.571428571428571,44.34285714285714,-39.77142857142857
82066,50,406,-356,924,5.411255411255411,43.93939393939394,-38.52813852813853
82067,43,511,-468,1122,3.832442067736185,45.54367201426025,-41.71122994652407
82068,32,411,-379,895,3.5754189944134076,45.92178770949721,-42.3463687150838
82069,37,413,-376,935,3.9572192513368987,44.17112299465241,-40.213903743315505
82070,33,371,-338,810,4.074074074074074,45.80246913580247,-41.72839506172839
82071,37,423,-386,926,3.995680345572354,45.68034557235421,-41.68466522678186
82072,41,425,-384,941,4.357066950053135,45.16471838469713,-40.807651434643994
82073,34,404,-370,900,3.7777777777777777,44.888888888888886,-41.11111111111111
82074,27,334,-307,733,3.6834924965893587,45.56616643929058,-41.882673942701224
82075,31,329,-298,724,4.281767955801105,45.44198895027624,-41.16022099447513
82076,26,304,-278,738,3.523035230352303,41.19241192411924,-37.669376693766935
82077,27,460,-433,986,2.738336713995943,46.65314401622718,-43.91480730223124
82078,42,489,-447,1075,3.9069767441860463,45.48837209302326,-41.58139534883721
82079,36,436,-400,976,3.6885245901639343,44.67213114754098,-40.983606557377044
82080,40,363,-323,840,4.761904761904762,43.214285714285715,-38.452380952380956
82081,36,341,-305,843,4.270462633451958,40.45077105575326,-36.1803084223013
82082,32,247,-215,569,5.623901581722319,43.40949033391915,-37.78558875219683
82083,13,80,-67,193,6.7357512953367875,41.45077720207254,-34.71502590673575
82084,43,527,-484,1148,3.7456445993031355,45.90592334494774,-42.160278745644604
82085,47,385,-338,881,5.334846765039727,43.70034052213394,-38.365493757094214
82086,35,284,-249,681,5.139500734214391,41.70337738619677,-36.56387665198238
82087,27,379,-352,827,3.2648125755743655,45.82829504232164,-42.563482466747274
82088,25,431,-406,924,2.7056277056277054,46.64502164502164,-43.93939393939394
82089,38,434,-396,950,4.0,45.68421052631579,-41.68421052631579
82090,36,419,-383,924,3.896103896103896,45.34632034632035,-41.45021645021645
82091,24,203,-179,455,5.274725274725275,44.61538461538462,-39.34065934065934
82092,39,529,-490,1144,3.4090909090909087,46.24125874125874,-42.83216783216783
82093,43,414,-371,922,4.663774403470716,44.90238611713666,-40.23861171366594
82094,34,421,-387,920,3.6956521739130435,45.76086956521739,-42.065217391304344
82095,55,559,-504,1235,4.4534412955465585,45.26315789473684,-40.80971659919028
82096,28,352,-324,767,3.650586701434159,45.89308996088657,-42.24250325945241
82097,52,433,-381,974,5.338809034907597,44.455852156057496,-39.1170431211499
82098,66,503,-437,1148,5.7491289198606275,43.815331010452965,-38.06620209059234
82099,35,508,-473,1096,3.1934306569343067,46.35036496350365,-43.15693430656935
82100,39,424,-385,938,4.157782515991471,45.20255863539446,-41.04477611940299
82101,22,397,-375,842,2.6128266033254155,47.149643705463184,-44.53681710213777
82102,23,368,-345,785,2.9299363057324843,46.87898089171975,-43.94904458598727
82103,26,298,-272,695,3.741007194244604,42.87769784172662,-39.13669064748202
82104,35,450,-415,983,3.560528992878942,45.77822990844354,-42.2177009155646
82105,42,430,-388,953,4.4071353620146905,45.12067156348373,-40.71353620146904
82106,2,1,1,6,33.33333333333333,16.666666666666664,16.666666666666664
82107,97,175,-78,549,17.66848816029144,31.876138433515482,-14.207650273224044
82108,0,2,-2,4,0.0,50.0,-50.0
82109,66,219,-153,570,11.578947368421053,38.421052631578945,-26.84210526315789
82111,0,0,0,0,0.0,0.0,0.0
82115,0,0,0,0,0.0,0.0,0.0
82117,0,0,0,0,0.0,0.0,0.0
82119,189,275,-86,952,19.852941176470587,28.886554621848738,-9.033613445378151
83001,48,466,-418,1041,4.610951008645533,44.764649375600385,-40.15369836695485
83002,18,263,-245,564,3.1914893617021276,46.63120567375886,-43.43971631205674
83003,28,421,-393,912,3.070175438596491,46.16228070175439,-43.0921052631579
83004,36,228,-192,529,6.805293005671078,43.10018903591683,-36.29489603024575
83005,12,130,-118,286,4.195804195804196,45.45454545454545,-41.25874125874126
83006,32,472,-440,1012,3.1620553359683794,46.6403162055336,-43.47826086956522
83007,25,497,-472,1049,2.3832221163012393,47.37845567206864,-44.9952335557674
83008,27,513,-486,1091,2.474793767186068,47.02108157653529,-44.54628780934922
83009,40,505,-465,1098,3.642987249544627,45.99271402550091,-42.349726775956285
83010,37,646,-609,1373,2.69482884195193,47.050254916241805,-44.35542607428987
83011,37,642,-605,1369,2.7027027027027026,46.89554419284149,-44.19284149013879
83013,42,631,-589,1351,3.1088082901554404,46.706143597335306,-43.59733530717987
83014,43,686,-643,1467,2.931152010906612,46.76209952283572,-43.830947511929104
83015,41,591,-550,1272,3.2232704402515724,46.4622641509434,-43.23899371069182
83016,42,618,-576,1329,3.160270880361174,46.50112866817156,-43.340857787810386
83017,24,598,-574,1248,1.9230769230769231,47.91666666666667,-45.99358974358975
83018,23,539,-516,1132,2.0318021201413425,47.61484098939929,-45.58303886925795
83019,27,405,-378,868,3.110599078341014,46.65898617511521,-43.5483870967742
83020,14,420,-406,877,1.596351197263398,47.890535917901936,-46.29418472063854
83021,17,481,-464,1002,1.6966067864271457,48.003992015968066,-46.30738522954092
83022,38,396,-358,872,4.3577981651376145,45.412844036697244,-41.05504587155963
83023,42,366,-324,832,5.048076923076923,43.99038461538461,-38.94230769230769
83024,12,259,-247,548,2.18978102189781,47.262773722627735,-45.07299270072993
83025,32,381,-349,834,3.8369304556354913,45.68345323741007,-41.84652278177458
83026,33,290,-257,647,5.1004636785162285,44.822256568778975,-39.72179289026275
83027,57,550,-493,1220,4.672131147540984,45.08196721311475,-40.40983606557377
83028,28,284,-256,630,4.444444444444445,45.07936507936508,-40.63492063492064
83029,31,399,-368,865,3.5838150289017343,46.127167630057805,-42.54335260115607
83030,32,386,-354,845,3.7869822485207103,45.680473372781066,-41.89349112426036
83031,19,539,-520,1123,1.6918967052537845,47.99643811219946,-46.30454140694568
83032,31,543,-512,1165,2.6609442060085837,46.60944206008584,-43.94849785407725
83033,39,523,-484,1131,3.4482758620689653,46.242263483642795,-42.79398762157383
83034,38,551,-513,1184,3.209459459459459,46.53716216216216,-43.3277027027027
83035,29,528,-499,1125,2.577777777777778,46.93333333333333,-44.355555555555554
83036,17,257,-240,552,3.0797101449275366,46.55797101449276,-43.47826086956522
83037,33,448,-415,969,3.4055727554179565,46.23323013415892,-42.827657378740966
83038,38,524,-486,1136,3.345070422535211,46.12676056338028,-42.78169014084507
83039,25,436,-411,928,2.693965517241379,46.98275862068966,-44.28879310344828
83040,16,420,-404,881,1.8161180476730987,47.67309875141884,-45.85698070374574
83041,22,429,-407,905,2.430939226519337,47.40331491712707,-44.972375690607734
83042,28,467,-439,994,2.8169014084507045,46.98189134808853,-44.16498993963783
83043,16,458,-442,951,1.6824395373291272,48.159831756046266,-46.47739221871714
83044,25,592,-567,1252,1.996805111821086,47.284345047923324,-45.287539936102235
83045,26,613,-587,1283,2.0265003897116136,47.77864380358535,-45.75214341387373
83046,36,425,-389,940,3.829787234042553,45.21276595744681,-41.38297872340426
83047,43,411,-368,917,4.689203925845147,44.82006543075245,-40.1308615049073
83048,49,427,-378,957,5.120167189132706,44.61859979101359,-39.49843260188088
83049,40,452,-412,994,4.0241448692152915,45.47283702213279,-41.4486921529175
83050,64,521,-457,1189,5.3826745164003365,43.81833473507149,-38.43566021867115
83051,37,551,-514,1184,3.125,46.53716216216216,-43.41216216216216
83052,44,520,-476,1138,3.8664323374340945,45.69420035149385,-41.82776801405976
83053,31,491,-460,1053,2.9439696106362776,46.628679962013294,-43.684710351377014
83054,31,412,-381,891,3.479236812570146,46.240179573512904,-42.76094276094276
83055,30,449,-419,962,3.118503118503119,46.67359667359668,-43.555093555093556
83056,27,570,-543,1210,2.231404958677686,47.107438016528924,-44.87603305785124
83057,21,622,-601,1298,1.6178736517719567,47.919876733436055,-46.3020030816641
83058,37,275,-238,629,5.88235294117647,43.72019077901431,-37.83783783783784
83059,51,503,-452,1122,4.545454545454546,44.83065953654189,-40.28520499108734
83060,26,188,-162,431,6.0324825986078885,43.619489559164734,-37.58700696055685
83061,25,333,-308,725,3.4482758620689653,45.93103448275862,-42.48275862068965
83062,25,235,-210,530,4.716981132075472,44.339622641509436,-39.62264150943396
83063,27,336,-309,732,3.6885245901639343,45.90163934426229,-42.213114754098356
83064,25,461,-436,981,2.54841997961264,46.99286442405708,-44.44444444444444
83065,16,392,-376,826,1.937046004842615,47.45762711864407,-45.520581113801455
83066,34,579,-545,1235,2.753036437246964,46.88259109311741,-44.12955465587045
83067,35,346,-311,778,4.4987146529562985,44.473007712082264,-39.97429305912597
83068,0,5,-5,10,0.0,50.0,-50.0
83069,43,584,-541,1268,3.391167192429022,46.05678233438486,-42.66561514195584
83070,60,588,-528,1310,4.580152671755725,44.88549618320611,-40.30534351145038
83071,48,628,-580,1363,3.521643433602348,46.074834922964044,-42.553191489361694
83072,30,378,-348,825,3.6363636363636362,45.81818181818182,-42.18181818181819
83073,25,557,-532,1179,2.1204410517387617,47.24342663273961,-45.122985581000854
83074,52,536,-484,1190,4.369747899159663,45.04201680672269,-40.67226890756303
83075,37,621,-584,1328,2.786144578313253,46.76204819277108,-43.97590361445783
83076,48,592,-544,1291,3.7180480247869867,45.855925639039505,-42.13787761425252
83077,33,500,-467,1069,3.086997193638915,46.77268475210477,-43.68568755846586
83078,27,427,-400,912,2.9605263157894735,46.82017543859649,-43.85964912280702
83079,30,645,-615,1352,2.2189349112426036,47.70710059171598,-45.48816568047337
83080,32,525,-493,1123,2.8495102404274264,46.74977738201246,-43.90026714158503
83081,31,627,-596,1330,2.330827067669173,47.14285714285714,-44.81203007518796
83082,44,667,-623,1429,3.0790762771168647,46.675997200839745,-43.596920923722884
83083,38,503,-465,1089,3.489439853076217,46.18916437098255,-42.69972451790633
83084,1,30,-29,68,1.4705882352941175,44.11764705882353,-42.64705882352941
83085,23,214,-191,479,4.801670146137787,44.676409185803756,-39.87473903966597
83086,20,285,-265,617,3.2414910858995136,46.19124797406807,-42.94975688816856
83088,35,417,-382,912,3.8377192982456143,45.723684210526315,-41.8859649122807
83089,28,315,-287,696,4.022988505747127,45.258620689655174,-41.235632183908045
84001,95,493,-398,1184,8.02364864864865,41.638513513513516,-33.61486486486487
84002,80,440,-360,1047,7.640878701050621,42.02483285577841,-34.38395415472779
84003,87,477,-390,1137,7.651715039577836,41.952506596306065,-34.30079155672823
84004,102,498,-396,1213,8.408903544929926,41.05523495465787,-32.64633140972794
84005,53,268,-215,643,8.242612752721618,41.679626749611195,-33.437013996889576
84006,49,427,-378,962,5.093555093555094,44.38669438669439,-39.29313929313929
84007,77,580,-503,1323,5.82010582010582,43.839758125472414,-38.01965230536659
84008,63,361,-298,862,7.308584686774942,41.87935034802784,-34.5707656612529
84009,47,316,-269,738,6.368563685636857,42.81842818428184,-36.449864498644985
84010,57,488,-431,1100,5.181818181818182,44.36363636363637,-39.18181818181819
84011,112,556,-444,1342,8.345752608047691,41.43070044709389,-33.0849478390462
84012,65,339,-274,817,7.9559363525091795,41.49326805385557,-33.537331701346396
84013,77,442,-365,1053,7.31244064577398,41.9753086419753,-34.66286799620132
84014,50,408,-358,938,5.330490405117271,43.49680170575693,-38.16631130063966
84015,85,401,-316,977,8.700102354145343,41.04401228249744,-32.3439099283521
84016,59,482,-423,1090,5.412844036697248,44.22018348623853,-38.80733944954129
84017,40,182,-142,447,8.94854586129754,40.7158836689038,-31.76733780760626
84018,32,376,-344,833,3.8415366146458583,45.13805522208884,-41.29651860744298
84019,63,467,-404,1072,5.8768656716417915,43.5634328358209,-37.68656716417911
84020,65,565,-500,1270,5.118110236220472,44.48818897637795,-39.370078740157474
84021,18,90,-72,223,8.071748878923767,40.35874439461883,-32.28699551569507
84022,18,111,-93,269,6.691449814126393,41.2639405204461,-34.572490706319705
84023,39,406,-367,907,4.299889746416759,44.76295479603087,-40.46306504961411
84024,49,367,-318,845,5.798816568047338,43.4319526627219,-37.63313609467456
84025,43,450,-407,1001,4.295704295704296,44.955044955044954,-40.65934065934066
84026,37,257,-220,598,6.187290969899665,42.97658862876254,-36.78929765886288
84027,40,352,-312,792,5.05050505050505,44.44444444444444,-39.39393939393939
84028,71,397,-326,947,7.497360084477296,41.92185850052798,-34.42449841605069
84029,44,302,-258,697,6.312769010043041,43.32855093256815,-37.01578192252511
84030,22,274,-252,598,3.678929765886288,45.819397993311036,-42.14046822742475
84031,25,250,-225,553,4.520795660036167,45.20795660036166,-40.6871609403255
84032,27,216,-189,490,5.510204081632653,44.08163265306123,-38.57142857142858
84033,52,314,-262,735,7.07482993197279,42.72108843537415,-35.646258503401356
84034,65,532,-467,1202,5.40765391014975,44.259567387687184,-38.85191347753744
84035,74,451,-377,1060,6.981132075471698,42.54716981132076,-35.56603773584906
84036,14,196,-182,422,3.3175355450236967,46.44549763033176,-43.12796208530806
84037,60,368,-308,866,6.928406466512701,42.494226327944574,-35.565819861431876
84038,86,442,-356,1071,8.029878618113912,41.269841269841265,-33.23996265172735
84039,72,434,-362,1039,6.9297401347449465,41.77093358999038,-34.84119345524543
84040,71,465,-394,1090,6.513761467889909,42.6605504587156,-36.14678899082569
84041,64,386,-322,917,6.9792802617230105,42.093784078516904,-35.11450381679389
84042,57,434,-377,989,5.763397371081901,43.882709807886755,-38.119312436804854
84043,86,450,-364,1090,7.889908256880735,41.284403669724774,-33.39449541284404
84044,44,337,-293,772,5.699481865284974,43.652849740932645,-37.95336787564767
84045,42,332,-290,753,5.577689243027888,44.090305444887115,-38.512616201859224
84046,65,329,-264,802,8.104738154613466,41.02244389027431,-32.917705735660846
84047,24,173,-149,396,6.0606060606060606,43.686868686868685,-37.62626262626262
84048,84,385,-301,955,8.795811518324607,40.31413612565445,-31.518324607329845
84049,16,140,-124,320,5.0,43.75,-38.75
84050,76,446,-370,1058,7.183364839319471,42.15500945179584,-34.97164461247637
84051,47,332,-285,765,6.143790849673202,43.39869281045752,-37.254901960784316
84052,42,247,-205,583,7.204116638078903,42.36706689536878,-35.16295025728988
84053,0,1,-1,2,0.0,50.0,-50.0
84054,51,366,-315,839,6.0786650774731825,43.62336114421931,-37.54469606674613
84055,68,387,-319,920,7.391304347826087,42.06521739130435,-34.673913043478265
84056,57,388,-331,900,6.333333333333334,43.111111111111114,-36.77777777777778
84057,75,414,-339,996,7.530120481927711,41.566265060240966,-34.036144578313255
84058,61,415,-354,961,6.347554630593131,43.18418314255983,-36.8366285119667
84059,54,399,-345,917,5.888767720828789,43.51145038167939,-37.6226826608506
84060,83,332,-249,843,9.845788849347569,39.383155397390276,-29.537366548042705
84061,51,408,-357,934,5.460385438972163,43.683083511777305,-38.222698072805144
84062,44,352,-308,801,5.493133583021224,43.94506866416979,-38.45193508114856
84063,42,312,-270,713,5.890603085553997,43.75876577840112,-37.86816269284712
84064,62,501,-439,1143,5.42432195975503,43.832020997375324,-38.40769903762029
84065,47,348,-301,796,5.9045226130653266,43.71859296482412,-37.814070351758794
84066,72,390,-318,933,7.717041800643088,41.80064308681672,-34.08360128617363
84067,59,403,-344,936,6.303418803418803,43.05555555555556,-36.75213675213676
84068,39,341,-302,775,5.032258064516129,44.0,-38.96774193548387
84069,29,203,-174,470,6.170212765957447,43.19148936170213,-37.02127659574469
84070,33,418,-385,915,3.606557377049181,45.68306010928962,-42.07650273224044
84071,84,487,-403,1157,7.260155574762317,42.09161624891962,-34.831460674157306
84072,61,465,-404,1057,5.7710501419110685,43.99243140964995,-38.221381267738884
84073,12,129,-117,285,4.2105263157894735,45.26315789473684,-41.05263157894737
84074,96,433,-337,1067,8.997188378631678,40.58106841611996,-31.583880037488285
84075,51,393,-342,901,5.660377358490567,43.61820199778024,-37.957824639289676
84076,14,49,-35,128,10.9375,38.28125,-27.34375
84077,53,353,-300,817,6.487148102815178,43.20685434516524,-36.719706242350064
84078,15,103,-88,236,6.3559322033898304,43.64406779661017,-37.288135593220346
84079,2,3,-1,10,20.0,30.0,-10.0
84080,58,439,-381,1013,5.725567620927937,43.33662388943731,-37.61105626850937
84082,78,445,-367,1061,7.351555136663525,41.94156456173421,-34.59000942507068
84083,75,418,-343,998,7.515030060120241,41.883767535070135,-34.368737474949896
84084,15,133,-118,306,4.901960784313726,43.4640522875817,-38.56209150326798
84085,32,233,-201,536,5.970149253731343,43.47014925373134,-37.5
85001,61,702,-641,1528,3.992146596858639,45.94240837696335,-41.95026178010471
85002,95,525,-430,1246,7.624398073836276,42.13483146067416,-34.51043338683788
85003,86,457,-371,1108,7.761732851985561,41.245487364620935,-33.48375451263537
85004,75,428,-353,1014,7.396449704142012,42.209072978303745,-34.81262327416173
85005,81,528,-447,1222,6.62847790507365,43.207855973813416,-36.579378068739764
85006,69,275,-206,708,9.745762711864407,38.84180790960452,-29.09604519774011
85007,88,393,-305,973,9.044193216855087,40.39054470709147,-31.346351490236387
85008,85,443,-358,1063,7.9962370649106305,41.67450611476952,-33.67826904985889
85009,59,416,-357,958,6.15866388308977,43.42379958246347,-37.265135699373694
85010,50,425,-375,962,5.197505197505198,44.17879417879418,-38.981288981288984
85011,49,357,-308,826,5.932203389830509,43.22033898305085,-37.288135593220346
85012,62,437,-375,1009,6.144697720515362,43.31020812685827,-37.16551040634291
85013,24,538,-514,1132,2.1201413427561837,47.52650176678445,-45.406360424028264
85014,46,259,-213,617,7.455429497568882,41.9773095623987,-34.52188006482982
85015,69,473,-404,1092,6.318681318681318,43.315018315018314,-36.99633699633699
85016,32,206,-174,484,6.6115702479338845,42.561983471074385,-35.9504132231405
85017,37,384,-347,849,4.358068315665489,45.22968197879859,-40.8716136631331
85018,9,18,-9,58,15.517241379310345,31.03448275862069,-15.517241379310345
85019,35,601,-566,1283,2.7279812938425563,46.843335931410756,-44.1153546375682
85020,37,593,-556,1274,2.904238618524333,46.546310832025114,-43.64207221350078
85021,46,570,-524,1249,3.682946357085669,45.6365092073659,-41.95356285028023
85022,42,385,-343,865,4.855491329479769,44.50867052023121,-39.653179190751445
85023,27,263,-236,584,4.623287671232877,45.034246575342465,-40.41095890410959
85024,42,544,-502,1188,3.535353535353535,45.79124579124579,-42.255892255892256
85025,34,387,-353,847,4.014167650531287,45.69067296340024,-41.676505312868954
85026,33,392,-359,857,3.8506417736289387,45.74095682613769,-41.890315052508754
85027,85,512,-427,1212,7.013201320132014,42.244224422442244,-35.23102310231023
85028,7,88,-81,190,3.684210526315789,46.31578947368421,-42.631578947368425
85029,44,362,-318,815,5.398773006134969,44.417177914110425,-39.01840490797546
85030,71,428,-357,1005,7.064676616915423,42.58706467661691,-35.52238805970149
85031,46,353,-307,807,5.700123915737299,43.74225526641883,-38.04213135068153
85032,50,236,-186,578,8.650519031141869,40.830449826989614,-32.179930795847746
85033,57,436,-379,999,5.7057057057057055,43.64364364364364,-37.93793793793794
85034,51,371,-320,854,5.971896955503513,43.44262295081967,-37.47072599531616
85035,0,0,0,0,0.0,0.0,0.0
85036,66,431,-365,1004,6.573705179282868,42.92828685258964,-36.354581673306775
85037,35,508,-473,1096,3.1934306569343067,46.35036496350365,-43.15693430656935
85038,54,320,-266,757,7.133421400264201,42.27212681638045,-35.13870541611625
85039,61,509,-448,1155,5.2813852813852815,44.06926406926407,-38.78787878787879
85040,50,250,-200,614,8.143322475570033,40.71661237785016,-32.57328990228013
85041,54,284,-230,680,7.941176470588235,41.76470588235294,-33.82352941176471
85042,58,395,-337,914,6.3457330415754925,43.21663019693654,-36.87089715536105
85043,77,404,-327,970,7.9381443298969065,41.649484536082475,-33.71134020618557
85044,95,379,-284,962,9.875259875259875,39.397089397089395,-29.52182952182952
85045,68,401,-333,948,7.172995780590717,42.29957805907173,-35.12658227848101
85046,38,299,-261,682,5.571847507331378,43.841642228739005,-38.26979472140763
85047,64,381,-317,899,7.119021134593993,42.380422691879865,-35.26140155728587
85048,71,503,-432,1166,6.089193825042882,43.138936535162955,-37.04974271012007
85049,66,397,-331,936,7.051282051282051,42.414529914529915,-35.363247863247864
85050,77,459,-382,1091,7.057745187901008,42.07149404216315,-35.01374885426215
85051,70,462,-392,1076,6.5055762081784385,42.93680297397769,-36.43122676579925
85052,64,443,-379,1022,6.262230919765166,43.34637964774951,-37.08414872798434
85053,83,487,-404,1157,7.17372515125324,42.09161624891962,-34.917891097666384
85054,89,526,-437,1245,7.148594377510039,42.24899598393574,-35.100401606425706
85055,94,533,-439,1277,7.3610023492560686,41.73844949099452,-34.37744714173845
85056,26,217,-191,492,5.284552845528456,44.105691056910565,-38.821138211382106
85057,65,299,-234,740,8.783783783783784,40.4054054054054,-31.62162162162162
85058,82,454,-372,1098,7.468123861566485,41.34790528233151,-33.87978142076503
85059,54,363,-309,850,6.352941176470588,42.705882352941174,-36.35294117647059
85060,63,322,-259,781,8.066581306017925,41.2291933418694,-33.162612035851474
85061,36,230,-194,543,6.629834254143646,42.35727440147329,-35.727440147329645
85062,85,459,-374,1095,7.76255707762557,41.917808219178085,-34.15525114155251
85063,62,329,-267,796,7.788944723618091,41.33165829145729,-33.5427135678392
85064,72,379,-307,913,7.886089813800658,41.51150054764513,-33.62541073384447
85065,65,416,-351,980,6.63265306122449,42.44897959183673,-35.816326530612244
85066,53,348,-295,808,6.5594059405940595,43.06930693069307,-36.509900990099005
85067,44,426,-382,950,4.631578947368421,44.8421052631579,-40.21052631578948
85068,88,451,-363,1091,8.065994500458295,41.338221814848765,-33.27222731439047
85069,52,444,-392,1020,5.098039215686274,43.529411764705884,-38.43137254901961
85070,56,291,-235,701,7.988587731811697,41.51212553495007,-33.523537803138375
85071,0,0,0,0,0.0,0.0,0.0
85076,0,0,0,0,0.0,0.0,0.0
85080,31,160,-129,392,7.908163265306123,40.816326530612244,-32.90816326530612
85081,50,377,-327,861,5.807200929152149,43.786295005807204,-37.97909407665506
85082,33,247,-214,562,5.871886120996441,43.95017793594306,-38.07829181494662
85083,33,283,-250,634,5.205047318611988,44.63722397476341,-39.43217665615142
85084,56,362,-306,846,6.619385342789598,42.78959810874704,-36.170212765957444
85085,45,184,-139,465,9.67741935483871,39.56989247311828,-29.892473118279568
86001,49,293,-244,687,7.132459970887918,42.64919941775837,-35.516739446870446
86002,96,493,-397,1191,8.060453400503778,41.39378673383711,-33.33333333333333
86003,71,322,-251,798,8.897243107769423,40.35087719298245,-31.45363408521303
86004,69,254,-185,651,10.599078341013826,39.01689708141321,-28.417818740399387
86005,55,248,-193,617,8.914100486223662,40.19448946515397,-31.28038897893031
86006,44,380,-336,858,5.128205128205128,44.28904428904429,-39.16083916083916
86007,72,342,-270,834,8.633093525179856,41.007194244604314,-32.37410071942446
86008,78,426,-348,1023,7.624633431085044,41.64222873900293,-34.01759530791789
86009,86,490,-404,1162,7.401032702237521,42.168674698795186,-34.767641996557664
86010,55,322,-267,762,7.217847769028872,42.25721784776903,-35.039370078740156
86011,73,434,-361,1025,7.121951219512194,42.34146341463415,-35.21951219512195
86012,88,432,-344,1050,8.380952380952381,41.14285714285714,-32.76190476190476
86013,96,395,-299,993,9.667673716012084,39.77844914400806,-30.110775427995975
86014,68,374,-306,893,7.61478163493841,41.881298992161256,-34.266517357222845
86015,65,458,-393,1051,6.1845861084681255,43.57754519505233,-37.392959086584206
86016,82,406,-324,982,8.350305498981669,41.34419551934827,-32.9938900203666
86017,110,386,-276,1002,10.978043912175648,38.522954091816366,-27.544910179640716
86018,102,413,-311,1049,9.723546234509056,39.37082936129647,-29.647283126787414
86019,98,461,-363,1126,8.703374777975133,40.94138543516873,-32.2380106571936
86020,91,486,-395,1161,7.838070628768304,41.86046511627907,-34.022394487510766
86021,5,75,-70,164,3.048780487804878,45.73170731707317,-42.6829268292683
86022,75,392,-317,942,7.961783439490445,41.6135881104034,-33.65180467091295
86023,66,339,-273,817,8.078335373317014,41.49326805385557,-33.414932680538556
86024,46,264,-218,629,7.3131955484896665,41.971383147853736,-34.65818759936407
86025,62,439,-377,1020,6.078431372549019,43.03921568627451,-36.96078431372549
86026,75,406,-331,969,7.739938080495357,41.89886480908152,-34.15892672858617
86027,93,339,-246,874,10.640732265446225,38.787185354691076,-28.14645308924485
86028,92,389,-297,969,9.494324045407637,40.14447884416924,-30.650154798761605
86029,82,449,-367,1070,7.663551401869159,41.96261682242991,-34.29906542056075
86030,81,305,-224,777,10.424710424710424,39.25353925353925,-28.828828828828826
86031,78,349,-271,865,9.017341040462428,40.346820809248555,-31.32947976878613
86032,79,419,-340,1006,7.852882703777336,41.65009940357853,-33.7972166998012
86033,74,508,-434,1172,6.313993174061433,43.344709897610926,-37.030716723549496
86034,86,481,-395,1141,7.537248028045573,42.15600350569676,-34.618755477651185
86035,70,284,-214,714,9.803921568627452,39.77591036414566,-29.971988795518207
86036,81,371,-290,911,8.89132821075741,40.724478594950604,-31.833150384193196
86037,35,324,-289,734,4.768392370572207,44.141689373297005,-39.3732970027248
86038,39,372,-333,836,4.6650717703349285,44.49760765550239,-39.83253588516747
86039,41,343,-302,773,5.304010349288486,44.372574385511,-39.06856403622251
86040,92,489,-397,1168,7.876712328767123,41.86643835616438,-33.98972602739725
86041,53,330,-277,769,6.8920676202860855,42.91287386215865,-36.02080624187256
86042,2,9,-7,22,9.090909090909092,40.909090909090914,-31.81818181818182
86043,19,98,-79,239,7.949790794979079,41.00418410041841,-33.05439330543933
86044,24,198,-174,452,5.3097345132743365,43.80530973451327,-38.49557522123894
86045,108,597,-489,1439,7.505211952744961,41.487143849895766,-33.9819318971508
86046,55,440,-385,1008,5.4563492063492065,43.65079365079365,-38.19444444444444
86047,41,520,-479,1134,3.6155202821869485,45.85537918871252,-42.23985890652557
86048,54,314,-260,754,7.161803713527852,41.644562334217504,-34.48275862068965
86049,46,286,-240,677,6.794682422451995,42.245199409158054,-35.45051698670606
86050,60,497,-437,1120,5.357142857142857,44.375,-39.017857142857146
86051,54,358,-304,838,6.443914081145586,42.720763723150355,-36.27684964200477
86052,101,461,-360,1140,8.859649122807017,40.43859649122807,-31.57894736842105
86053,49,360,-311,821,5.9683313032886725,43.8489646772229,-37.88063337393423
86054,52,280,-228,668,7.784431137724551,41.91616766467065,-34.1317365269461
86055,103,434,-331,1085,9.493087557603687,40.0,-30.506912442396313
86056,76,396,-320,954,7.966457023060797,41.509433962264154,-33.542976939203356
86057,109,393,-284,1014,10.749506903353057,38.75739644970414,-28.00788954635108
86058,75,356,-281,867,8.650519031141869,41.061130334486734,-32.410611303344865
86059,73,391,-318,942,7.749469214437367,41.50743099787686,-33.75796178343949
86060,3,47,-44,102,2.941176470588235,46.07843137254902,-43.13725490196079
86061,64,256,-192,643,9.953343701399689,39.813374805598755,-29.860031104199066
86062,53,321,-268,754,7.029177718832891,42.57294429708223,-35.54376657824934
86063,80,469,-389,1107,7.226738934056007,42.36675700090334,-35.14001806684733
86064,103,437,-334,1091,9.440879926672777,40.05499541704858,-30.614115490375802
86065,55,214,-159,544,10.11029411764706,39.338235294117645,-29.227941176470587
86066,68,476,-408,1093,6.221408966148216,43.54986276303751,-37.32845379688929
86067,85,364,-279,917,9.269356597600872,39.69465648854962,-30.425299890948747
86068,43,223,-180,534,8.05243445692884,41.760299625468164,-33.70786516853933
86069,73,358,-285,868,8.410138248847925,41.244239631336406,-32.834101382488484
86070,15,308,-293,651,2.3041474654377883,47.31182795698925,-45.00768049155146
86071,52,276,-224,660,7.878787878787878,41.81818181818181,-33.93939393939394
86072,37,201,-164,481,7.6923076923076925,41.78794178794179,-34.0956340956341
87001,9,59,-50,137,6.569343065693431,43.06569343065693,-36.4963503649635
87002,56,350,-294,821,6.82095006090134,42.630937880633375,-35.80998781973204
87003,35,181,-146,435,8.045977011494253,41.60919540229885,-33.5632183908046
87004,50,363,-313,851,5.875440658049354,42.65569917743831,-36.78025851938895
87005,50,299,-249,703,7.112375533428166,42.53200568990042,-35.41963015647226
87006,88,445,-357,1088,8.088235294117647,40.900735294117645,-32.8125
87007,39,317,-278,716,5.4469273743016755,44.273743016759774,-38.8268156424581
87008,26,322,-296,710,3.6619718309859155,45.352112676056336,-41.690140845070424
87009,66,342,-276,829,7.961399276236429,41.25452352231604,-33.293124246079614
87010,51,419,-368,953,5.351521511017839,43.96642182581322,-38.614900314795385
87011,56,438,-382,1002,5.588822355289421,43.712574850299404,-38.12375249500998
87012,14,175,-161,386,3.6269430051813467,45.33678756476684,-41.70984455958549
87013,21,106,-85,258,8.13953488372093,41.08527131782946,-32.945736434108525
87014,22,155,-133,360,6.111111111111111,43.05555555555556,-36.94444444444444
87015,10,92,-82,208,4.807692307692308,44.230769230769226,-39.42307692307692
87016,21,121,-100,287,7.317073170731707,42.1602787456446,-34.843205574912886
87017,31,160,-129,386,8.031088082901555,41.45077720207254,-33.41968911917098
87018,69,388,-319,926,7.4514038876889845,41.90064794816415,-34.449244060475166
87019,73,386,-313,930,7.849462365591398,41.50537634408602,-33.65591397849462
87020,90,458,-368,1106,8.1374321880651,41.41048824593128,-33.273056057866185
87021,12,118,-106,264,4.545454545454546,44.696969696969695,-40.15151515151515
87022,23,298,-275,645,3.565891472868217,46.2015503875969,-42.63565891472869
87023,62,284,-222,700,8.857142857142856,40.57142857142857,-31.714285714285715
87024,41,242,-201,575,7.130434782608695,42.08695652173913,-34.95652173913044
87025,26,206,-180,470,5.531914893617021,43.829787234042556,-38.297872340425535
87026,64,491,-427,1123,5.699020480854853,43.722172751558325,-38.02315227070347
87027,63,320,-257,782,8.05626598465473,40.92071611253197,-32.86445012787724
87028,81,551,-470,1267,6.393054459352802,43.48855564325177,-37.09550118389897
87029,76,313,-237,795,9.559748427672957,39.37106918238994,-29.81132075471698
87030,22,179,-157,404,5.445544554455446,44.306930693069305,-38.86138613861386
87031,41,297,-256,683,6.002928257686676,43.48462664714495,-37.48169838945827
87032,46,388,-342,880,5.227272727272727,44.09090909090909,-38.86363636363637
87033,70,334,-264,818,8.557457212713937,40.831295843520785,-32.27383863080685
87034,82,376,-294,917,8.942202835332607,41.00327153762268,-32.06106870229007
87035,57,474,-417,1072,5.317164179104478,44.21641791044777,-38.899253731343286
87036,75,419,-344,1006,7.455268389662027,41.65009940357853,-34.1948310139165
87037,111,528,-417,1281,8.665105386416862,41.21779859484778,-32.55269320843092
87038,43,298,-255,686,6.2682215743440235,43.440233236151606,-37.17201166180758
87039,86,591,-505,1370,6.2773722627737225,43.13868613138686,-36.86131386861314
87040,105,518,-413,1252,8.386581469648563,41.373801916932905,-32.98722044728434
87041,57,429,-372,982,5.8044806517311605,43.686354378818734,-37.88187372708757
87042,50,505,-455,1128,4.432624113475177,44.769503546099294,-40.336879432624116
87043,0,0,0,0,0.0,0.0,0.0
87044,33,96,-63,261,12.643678160919542,36.7816091954023,-24.137931034482754
87045,20,60,-40,160,12.5,37.5,-25.0
87046,119,497,-378,1256,9.474522292993631,39.57006369426752,-30.095541401273884
87047,62,664,-602,1480,4.1891891891891895,44.86486486486487,-40.67567567567568
87048,66,622,-556,1383,4.772234273318872,44.97469269703543,-40.20245842371656
87049,63,626,-563,1400,4.5,44.714285714285715,-40.214285714285715
87050,35,544,-509,1166,3.0017152658662094,46.65523156089194,-43.65351629502573
87051,49,548,-499,1209,4.052936311000828,45.32671629445823,-41.2737799834574
87052,56,564,-508,1270,4.409448818897638,44.40944881889764,-40.0
87053,61,571,-510,1283,4.75448168355417,44.50506625097428,-39.75058456742011
87054,87,605,-518,1391,6.2544931703810205,43.493889288281814,-37.239396117900796
87055,98,677,-579,1565,6.261980830670927,43.25878594249201,-36.99680511182108
87056,74,660,-586,1484,4.986522911051213,44.474393530997304,-39.487870619946094
87057,101,630,-529,1479,6.8289384719405,42.59634888438134,-35.76741041244084
87058,79,572,-493,1312,6.021341463414634,43.59756097560975,-37.57621951219512
87059,38,487,-449,1061,3.581526861451461,45.90009425070688,-42.31856738925542
87060,55,684,-629,1493,3.6838580040187545,45.813797722705964,-42.12993971868721
87061,77,653,-576,1474,5.223880597014925,44.30122116689281,-39.07734056987788
87062,36,363,-327,810,4.444444444444445,44.81481481481481,-40.37037037037037
87063,12,80,-68,184,6.521739130434782,43.47826086956522,-36.95652173913044
87064,0,0,0,0,0.0,0.0,0.0
87065,77,322,-245,809,9.517923362175525,39.80222496909765,-30.284301606922128
87066,75,487,-412,1180,6.3559322033898304,41.271186440677965,-34.91525423728814
87067,61,432,-371,998,6.112224448897796,43.28657314629258,-37.174348697394784
87068,114,560,-446,1377,8.278867102396514,40.66811909949165,-32.38925199709513
87069,81,455,-374,1082,7.486136783733826,42.05175600739371,-34.56561922365989
87070,41,315,-274,715,5.734265734265734,44.05594405594406,-38.32167832167833
87071,30,257,-227,577,5.1993067590987865,44.54072790294627,-39.341421143847484
87072,71,356,-285,861,8.246225319396052,41.347270615563296,-33.10104529616724
87073,6,62,-56,137,4.37956204379562,45.25547445255474,-40.87591240875912
87074,95,525,-430,1247,7.618283881315156,42.10104250200481,-34.48275862068965
87075,76,390,-314,945,8.042328042328043,41.269841269841265,-33.22751322751322
87076,92,387,-295,977,9.416581371545547,39.611054247697034,-30.194472876151487
87077,81,519,-438,1215,6.666666666666667,42.71604938271605,-36.04938271604939
87078,108,423,-315,1077,10.027855153203342,39.27576601671309,-29.247910863509752
87079,21,135,-114,321,6.5420560747663545,42.05607476635514,-35.51401869158878
87080,82,338,-256,849,9.65842167255595,39.811542991755005,-30.153121319199055
87081,63,398,-335,928,6.788793103448276,42.887931034482754,-36.09913793103448
87082,31,327,-296,721,4.2995839112343965,45.35367545076283,-41.05409153952843
87083,1,16,-15,35,2.857142857142857,45.714285714285715,-42.85714285714286
87084,64,314,-250,762,8.398950131233596,41.20734908136483,-32.808398950131235
87085,62,548,-486,1227,5.052974735126324,44.66177669111654,-39.60880195599022
87086,51,505,-454,1118,4.561717352415027,45.169946332737034,-40.60822898032201
87087,53,600,-547,1316,4.027355623100304,45.59270516717325,-41.565349544072944
87088,46,290,-244,687,6.695778748180495,42.21251819505095,-35.51673944687045
87089,36,357,-321,790,4.556962025316456,45.18987341772152,-40.63291139240506
87090,0,0,0,0,0.0,0.0,0.0
87092,0,0,0,0,0.0,0.0,0.0
87093,0,0,0,0,0.0,0.0,0.0
87096,32,198,-166,467,6.852248394004283,42.398286937901496,-35.54603854389721
87097,56,372,-316,864,6.481481481481481,43.05555555555556,-36.574074074074076
87098,68,500,-432,1154,5.892547660311958,43.327556325823224,-37.43500866551126
87099,62,458,-396,1044,5.938697318007663,43.86973180076628,-37.93103448275862
87100,30,331,-301,731,4.1039671682626535,45.280437756497946,-41.17647058823529
87101,67,415,-348,972,6.893004115226338,42.69547325102881,-35.80246913580247
87102,30,339,-309,744,4.032258064516129,45.564516129032256,-41.53225806451613
